11
7
1
S121....000
.2P2....0P0
.121E...000
.........2.
..11....121
.1P1....1P1
.111....11.

chavs -3/0/0
portals 1 0 3 2
