15
10
1
...e...........
...0...........
...I..........
...I...........
...I...........
...I...........
...I...........
...0IIIIIII000e
...0.......0...
...e.......e...

entrances 206/6 206/7 206/12 206/14 206/15
