15
10
1
...e.......e...
...0.......0...
...00000...I...
.......I...I...
.......I...I...
.......I...I...
e000...000III0e
...0.......I...
...0.......0...
...e.......e...

entrances 206/7 206/8 206/11 206/9 206/15 206/16
