10
10
1
..231.....
..S111111.
..11....1.
122211111.
.111......
.111......
1221......
3542222221
222111111E
111.......

jumps 
