9
9
1
000000000
0.......0
0.......0
00.....00
0.......0
0.......0
0.......0
0000S0000

