20
15
1
22222222222222222222
21111111111111111112
21S11111111111111112
21111111111111111112
21111111111111111112
21111111111111111112
21111111111111111112
21111111111111111112
21111111111111111112
21111111111111111112
21111111111111111112
21111111111111111112
21111111111111111E12
21111111111111111112
22222222222222222222
