18
13
1
..................
..................
..................
..................
..................
..................
..................
..................
..................
..................
..................
...........00e....
e00000000000......

entrances 204/0 400/4
