12
5
2
............
............
..111111L1..
............
............

..S1....121.
1341....242.
131221112122
1212....2411
..E1....12..
