8
6
1
.S....E.
.1....1.
.1....1.
.N..1..u
.1....1.
.111111.

pistons >

