18
14
1
..................
..................
..................
..................
..................
..................
..................
..................
.................e
.................0
.................0
.................0
.................0
.........K00000000

entrances 400/5
