10
10
1
.21...111.
1421112231
252.....1.
241.....1.
.21....S1.
.21....11.
.21....11.
23E11..11.
1.1.1..11.
..1121.11.

jumps 
