10
5
2
..........
..........
.122221...
111NN1121E
1233321...

..S.......
..v.......
..v.......
..........
..........

pistons > <
