10
10
1
.1.....131
.2......2.
.2......2.
.2......2.
.2......2.
.2......S.
.2......3.
12......31
1211233487
.1E....134

jumps 
