10
10
1
..........
..........
3555554311
11123S3E33
.....2...2
.....2...1
.....21...
.....11...
.....11...
.....22...

jumps 
