10
5
1
121.......
121..E....
12....M.OS
121.......
121.......

ones <
