16
24
1
................
................
................
................
................
................
................
................
.T.ES...........
00.J0...........
0J.000000000000.
00.NNNNNNNNNNNN.
.0..............
.0..............
.0..............
.>..............
.0..............
.0..............
.0..............
.0..............
.0..1111.1..11..
.101....1.11..11
....0000.0..00..
...0....0.00..0.

pistons v v v v v v v v v v v v
jumps 2 2
