10
10
1
2111......
3E22111111
3121.....1
2121111122
22333333S2
.......121
.......11.
.......11.
.......11.
.......11.

jumps 
