9
7
1
.8888888.
.8888888.
.888J888.
S8888888E
.888J888.
.8888888.
.8888888.
