15
15
2
...............
...v<<<<<<<....
..L<>>>>L<v....
..........v....
..........v....
..........v....
...............
...............
...............
...............
...............
...............
...............
...............
...............

..>v>v..>v>v...
..^M.<..^M.<...
S1>MMv..>MMv...
..^<^<..^<^<...
...............
...............
...............
...............
...............
...............
...............
...............
...............
...............
...............
