12
8
1
SI1IIIIIII1I
1I1I1III1III
1IIIIIIIIIII
1IIIII1IIIIE
1III1I1IIIII
1III1III1III
1IIIIIIIIIII
1I1IIIIIII1I