10
7
1
S1....111.
.1P1112P1.
......1...
.111..111.
.1P2111P1.
...1......
...E......

portals 1 0 3 2
