10
5
1
S11111....
.1P..1P1..
.^1111121E
.1111111..
.1P...P1..

portals 1 0 3 2
