11
9
1
..111...11.
112E222221.
1233443221.
.111211....
.111212111.
.1112.1..1.
....212111.
....22321S1
......11111
