9
7
1
...11....
...1111..
..11..1..
S1223221E
..1..11..
..1111...
....11...
