17
21
1
..v.v.v.v.v.e.v..
............M....
.................
.................
.................
.................
.................
.e.e.e.e.e.e.e.e.
00.0.0.0.0.0.0.0.
0..M.M.M.M.M.M.M0
0...............0
0M..1.1.1.1.1.1.0
00000000000000000
e.eee.R..........
.................
.................
.................
.................
.................
.................
.................

entrances 202/0 8/4 8/5 8/6 8/7 8/8 8/9 8/10 8/11 400/4 8/1 8/2 8/3
