8
6
2
101..11.
1.1...0.
.....11.
.1......
0....M1.
11...E1.

........
........
........
........
......S.
......0.
