8
6
2
101..11.
1.1...0.
.....11.
11......
0....M..
11...E..

........
........
........
........
......S.
......0.