8
6
1
.....E..
.....1..
.....11.
S1111>32
.....2.2
.....222