8
6
1
.....E..
.....1..
.....11.
S1111>32
.....1.2
.....222