8
6
2
202..12.
1.1...0.
.....12.
21......
0....M..
21...E..

........
........
........
........
......S.
......0.