9
9
1
...3.....
E..6.....
1..S.....
1..3.....
1..3.....
1..I.....
1..3.....
1..3.....
1112.....
