11
11
1
12222233S34
.1222222115
.......1..4
.......1..5
.......1227
........1.5
........116
..........7
........13E
...........
...........
