9
9
1
111113111
1....4..1
1....4..1
1....4..1
1...S^<11
1........
1........
1........
E........
