11
11
1
...........
.......1111
.......1..1
12123111122
.1124132121
...S4232243
.12351211E2
12222.11231
........111
........1.1
........111
