11
11
1
1...111....
2...1.S....
2...1......
2...1......
21111..1...
1......2...
21111124111
2..122E7443
2.....24..1
2.....24222
1.....24442
