9
9
1
..E112111
..2..^v11
..2...1I1
..2.....1
..^.....1
..2.....1
..S.....1
..1.....1
..1111111
