11
11
1
.......2455
....1223225
.....1...14
12111E...14
.1.122....3
.1.122....4
11.133....5
1...12....5
11112311114
....S2....1
.....1.....
