9
9
1
...311121
...5...I.
...5...I.
...S...1.
...^...1.
.......I.
.......v.
.......3.
.......2E
