12
12
1
.......12221
.....12321..
.....112...1
12222222...2
......111113
......11111E
...122222223
.1.........1
.31111111S.1
.3.........1
.3...1.....1
131113333321
