9
9
1
.......E.
.......^1
........1
........1
........1
1.......1
2.......1
2...S...1
344443211
