9
9
1
111E.....
1........
1........
21S......
4<.......
31.......
3I.......
3^.......
2222221..
