9
9
1
232222221
1v.......
1S.......
12.......
1E.......
11.......
2I.......
31.......
21.......
