9
9
1
.1......1
.2......2
.S......2
.1......E
.1......3
.11.....3
.>2.....3
..v.....3
..1111112
