9
9
1
3..1.....
E<12.....
3^.1.....
2..1.....
2..^1S...
3........
4........
4........
2........
