9
9
1
...1.....
11<S<....
1..^.....
1........
1.......E
2.......1
4.......1
5.......1
311111111
