9
9
1
.........
......S11
........2
........3
........3
........3
........3
........E
122222343
