9
9
1
E1131....
111^.....
1........
1........
1........
1........
1....1Sv.
1......5.
111111141
