9
9
1
211114...
3....^...
3....1...
3....S...
3....^...
3........
2........
1........
1111E....
