9
9
1
.1112355E
.>1>^..21
.......21
.......21
.......^1
.......11
.......1.
.......S.
.......1.
