9
9
1
1........
2......>2
2......S1
2......^1
2.......1
E.......1
3.......1
3.......1
211111111
