9
9
1
......112
E.....1.2
1...vI211
1...1.111
1..v<.I11
1..v..S^1
11<1..^..
..11.....
..11.....
