9
9
1
.31......
20<......
1^.......
1^.......
23I2S....
1........
E........
2........
1........
