8
8
1
11111221
1....1..
1..E.11.
2..1..1.
4..1..12
4..11..3
3...1..3
22321..S
