9
9
1
1........
2........
2........
3......S.
4......I.
4......1.
4......I.
4......I.
E11111121
