8
8
1
....1111
....1232
....11..
111121..
2S7631..
1322....
.1.2....
.E.1....
