9
9
1
........1
........2
.>2222124
.....1..3
.....1.>E
.....1.I1
.....1.11
.....>1S1
.......1.
