8
8
1
.....E21
111...1.
211...1.
2.....1.
2....132
2.....12
2.....22
33S12463
