9
9
1
1........
2........
E<23S4<..
1..1.....
1..1.....
1..1.....
1..1.....
1..2.....
1112.....
