9
9
1
1........
2........
2........
2........
2........
2........
2........
3111S....
333E22221
