9
9
1
.........
.........
.........
.........
.........
..v......
..S......
..3......
E35444442
