9
9
1
21111E...
3........
3........
3........
3........
3........
3S.......
3<.......
222221...
