8
8
1
........
........
.S......
.1......
.1.....2
1211...4
...1...3
...150E0
