9
9
1
.........
.........
.........
1........
2......S.
31E....1.
3<3v1111.
3.^6.....
2..3.....
