8
8
1
........
....1232
.S...121
.1...11.
13222E42
.1....1.
.2....1.
25322331
