9
9
1
2........
4........
4........
4...v....
E...S....
3...2....
3...1....
3...1....
21111....
