9
9
1
1........
2........
2S2I2<...
1........
1........
1........
1........
2v.......
25111E221
