9
9
1
1....1...
2....S...
2....v...
32222<...
2...1....
2...1....
E111<....
4........
2........
