9
9
1
.........
.........
.........
.........
.....>E<.
.....1..1
.....1..2
...S>3223
........1
