9
9
1
........1
........3
......>16
......1.E
......1.4
......1.4
......1.4
......S.4
........2
