8
8
1
........
........
1......1
21111..2
22S12232
11212241
111.1131
...13E53
