9
9
1
11111311.
1<1<I6I31
.....5.11
.....^..1
.....I..E
.....S...
.........
.........
.........
