9
9
1
.........
.........
.........
.........
..>E<....
..Sv.....
..31.....
..2......
..1......
