9
9
1
........1
........2
........2
........3
........4
........4
E.....S.4
1.....1.4
111111223
