9
9
1
......2..
......4..
......4..
......S..
......3..
E.....3..
1.....3..
1.....3..
111111321
