9
9
1
.....1...
.....2...
...>>3111
...1.2>S3
...11211E
.....1..1
.....1..1
.....1..1
.....1111
