8
8
1
.1442322
....1213
12357E33
....1122
..S11112
.......1
........
........
