9
9
1
......E.2
......I.4
..v111214
..1...1S3
..v...1.2
..>1>1^.2
........2
........2
........1
