9
9
1
.........
.........
..>111111
..1Sv...1
..^.7...1
..^16...1
....4...1
....^...1
........E
