9
9
1
........1
........2
........2
........2
.......S2
.......12
.......13
.......14
...1234E4
