9
9
1
1........
2........
2........
2........
3S.......
E........
4........
4........
322222221
