8
8
1
23433332
..411211
S58222..
.15121..
..2.1...
..1.E...
........
........
