9
9
1
.........
.........
.........
.........
.........
.........
....1v2S1
E..>33>I5
111232114
