9
9
1
2........
41I1<....
3...1....
E...I....
3...1....
2...1....
2.>12v...
2.S.11...
1...11...
