9
9
1
..111....
..212>1v.
..2.1S.1.
..^.^1.v.
....1<.v.
...1I115.
...E...^.
...2.....
...1.....
