9
9
1
1S1112222
11...1..2
11...1..2
11...1112
.12224421
....142..
..244E1..
.....1...
.........
