9
9
1
.......1.
......132
......113
1.....114
211111244
1.....253
1.....122
1.....123
111111S2E
