9
9
1
..1.....1
.S2.1...2
12213...2
....3...2
....2...2
....1...2
.E1121223
....1...3
123564322
