9
9
1
.1E333443
1222S1112
....2...1
...122222
...1...11
...1...22
...111124
........4
........2
