9
9
1
12222222E
........1
111111..2
1....1..2
1S2112222
112111111
1.111111.
111111132
.......11
