9
9
1
111111452
354222332
S.......1
........1
........2
........3
.....1124
....12112
....1E321
