9
9
1
....11112
....^...2
....S...1
....^...1
........E
........2
........2
........2
122222233
