9
9
1
2221.....
S.11.....
3.121....
21111....
....1.122
.11122222
.1.....11
.21111E11
144432111
