9
9
1
.13S12332
..2211111
..21.....
1.E1.....
3111.....
455664342
.........
.........
.........
