9
9
1
2453....2
1..111237
1.......7
1.......5
1.......2
1..1E1111
1........
2443S2221
.........
