9
9
1
........1
........2
........2
........2
........2
..vI1<112
..S.....1
..2.....1
..2222E32
