9
9
1
......111
......1.1
.....11.1
..1223323
.....1214
.....2313
.1245E322
.1112111S
...132111
