10
10
1
111111111.
1.11....1.
1.11....21
1S33211.23
.133334446
......1435
.......113
.........E
..........
..........
