10
10
1
.........2
1........4
3333212214
3S33211..4
1....11..3
1....1211E
1.....1..4
1.....1..3
1.....1..2
1111111..1
