9
9
1
...1.....
...2.....
1..2.....
21vE.....
1v<1.....
1>12<....
2<....Sv.
3^.....1.
21111111.
