10
10
1
..........
.........E
.........1
.....11112
..11111113
S.1...1..3
1.1..12114
2221122..4
1....12.14
1111124586
