10
10
1
.122223E22
......1113
.........3
.........3
.........2
..12222112
......1..2
.S11113213
2111112212
2111112321
