10
10
1
........S1
........21
.1.1....21
153533312E
1413223131
1444..2.1.
.1.2..1.1.
.11311111.
...2......
...1......
