9
9
1
11111111.
1......1.
1......^.
1......1.
1.....SI.
1.....1^.
11>v..11.
...1..13.
23E1...2.
