10
10
1
..........
..........
..........
........E1
1S22443222
1...2..111
1...2..111
1244533443
..1.1....1
1221223431
