10
10
1
..12224213
......3126
......2..4
......3347
......1..5
......1..5
......23E4
.......232
.....122S4
.........1
