10
10
1
..........
.........1
........14
.........3
.....S1..2
...1222113
..1112222E
..11232235
..1..1..16
.121124677
