10
10
1
.....2455E
.....21140
.....1..47
........35
........14
........14
........24
.....11122
.....1.S11
1222221111
