10
10
1
.......211
.......3.2
......2757
.1211112.6
..1....1.6
..11111425
......163E
.......324
.......113
.......S.1
