18
11
1
..................
..................
..................
.......e..........
.......0..........
.????S0000m0e.....
..................
..................
..................
..................
..................

entrances 1/0 400/1
map_bridges 1
