15
11
1
..1.3.0.0...e..
...e...e....0..
...0...0....0..
...m...0....0..
...0...0....0..
e000000000mm00e
.......0.......
.......0.......
.......0.......
.......e.......
......I.I......

entrances 301/0 101/0 2/0 400/0 400/2 3/0
map_bridges 1 2 3
