15
19
1
...............
...............
...............
...............
..1.3.0.0......
...e...e.......
...0...0....e..
...m...0....0..
...0...0....0..
e000000000mm000
...?...0......0
...?...0......0
...?...e......0
...?..I.I.....0
...?..........e
...?...........
...?...........
...?...........
...e...........

entrances 101/0 2/0 301/0 400/1 3/0 400/3 202/0
map_bridges 1 2 3
