15
11
2
...............
...............
...........e...
...........0...
...........L...
...............
..<.e000L......
.>^.00000......
...............
...............
...............

.......1......e
..21..12......0
..1...........0
...........0..0
..J.e0000m00000
....00000....0.
........0....m.
...........e.m.
...........0.m.
e00IIIIIII0000.
...............

entrances 4/0 6/0 400/2 5/0 302/0 400/4
map_bridges 4 5 6 7
