10
10
1
..........
..........
..........
..........
..........
....0.....
....0.....
....0.....
....0.....
....e.....

entrances 400/1
