10
10
1
..........
..........
..........
..........
..........
e0000.....
....0.....
....0.....
....0.....
....e.....

entrances 401/0 400/1
