12
10
3
............
............
............
............
............
............
............
....L000e.>.
....00000.<^
............

............
..e.........
..0.........
..L....0....
.......0....
....L000e.M.
....00000...
....0.......
............
............

.....1......
.....21..12.
..0.......1.
e00m0000e...
.0..00000.J.
.m..0.......
.m..........
.m..........
.000e.......
.e..........

entrances 7/0 4/0 6/0 2138/1 5/0 1002/0 2138/3
map_bridges 4 5 6 7
