11
8
3
...........
...........
...........
...........
...........
...........
....L000e.D
....00000.B

..e........
..0........
..L........
...........
....L000e.M
....00000..
....0......
...........

.........12
..0.......1
e00m0000e..
.0..00000.J
.m..0......
.m.........
.m.........
.e.........

entrances 7/0 4/0 6/0 2138/1 5/0 2138/3
map_bridges 4 5 6 7
