11
11
1
.231..1....
..11..2....
..11..>1v..
11<^1.J1<..
E.....J..>3
......1.1>2
......^.221
......I.11.
......2.1S.
......3.12.
......2111.

jumps 2 3 
