11
11
1
.....21....
.....1.....
.....v.....
.....J.....
.....1....E
1.........2
212211J1113
112J.JJ.J.2
..^S.1.>112
....1^.1..2
...11221..1

jumps 3 2 3 3 2 2 
