11
11
1
...........
...........
....v1.....
....v......
1321>21J113
.1...J..1E3
.1....>2211
.I...J.....
.1v..2.....
13S2<2.....
.11.12.....

jumps 3 3 2 
