11
11
1
32.........
221111<1112
1>J.22II2E3
23<.......1
..1.....S>1
..I.......1
..^I111.J11
...........
...........
...........
...........

jumps 2 2 
