11
11
1
...........
...........
...........
....J..J1S1
11..J1<.JI1
1v1........
.12........
.12Ev......
..J^J.....1
.>222222I23
13311.....1

jumps 3 3 3 2 2 2 
