11
11
1
....11.....
11<12<.....
1..........
1...J......
1I11E..S...
1111J..>J.1
111.J2<..11
........1>1
......J.J11
......2....
......21221

jumps 3 3 2 2 2 2 
