11
11
1
......1....
......2....
......1....
31..J<<....
31IJ.IJ..11
.........12
.........12
......Jv111
111111SE221
11I1<13<...
......1....

jumps 3 2 3 3 
