11
11
1
...111211..
...1^1112..
...I...11..
12S2J..1J..
...1....1.E
...J....>12
211<....J.1
2v......1..
.1.J....^..
.11211111..
...1.......

jumps 3 2 3 2 2 
