11
11
1
...12231...
...1^11....
.....1J....
.....S.....
...J.JJ....
...1..J....
.....2^....
...J.2.....
12231v.....
21v32<.....
E221.......

jumps 2 3 2 2 3 2 
