11
11
1
..11...1111
..11...1111
..1I...1S21
..1^..J12I1
E1<.....v11
.......J111
.......I>I3
.......1.12
.......1.11
.......1.1.
.......111.

jumps 3 3 
