11
11
1
........111
........1.1
.11J.11J111
.^......J..
.S.........
........1..
.....v11211
.....J..J.1
...>1>2>J.2
...1.22232E
...112111..

jumps 2 2 2 3 2 2 
