11
11
1
...........
1111<......
1111IJ.1111
..........E
....J......
...........
...........
22J1J.J21I1
....1.>S332
....I.^2...
....1133...

jumps 2 2 2 3 3 
