11
11
1
.....1322..
......2.2..
......I.2..
.....S2.2..
...>223v...
......2JJ..
......v.2..
......JJ2..
........2..
.......>321
......E221.

jumps 2 2 3 2 
