11
11
1
221.11.....
33222211111
2EI1J333I<2
..........2
..........1
.....J.....
...........
.....J.....
.....S.....
...........
...........

jumps 2 3 2 
