11
11
1
........122
........1>2
......>I211
.>2>IJ^.J11
...1.......
11I^....1.1
11..J..JI12
........SE1
........221
........11.
........22.

jumps 3 2 3 3 
