11
11
1
.......1231
.........1.
.........1.
.......J.v.
..E11.J2I1.
...........
...........
....v..J111
...>2I11.11
1223S1I1>21
...22..1221

jumps 3 2 3 
