11
11
1
...1122....
...1.^E....
...1..2....
.>I^..31>1.
.I....^..1.
.1....1..1.
.1....1..v.
1^....1..3.
1.JI11S..I.
......1..3.
......1123.

jumps 2 
