11
11
1
.2222111...
.E>1I111...
1333JJ3<...
.....^.....
...........
...........
.S...J.....
11...1.....
32J.1^.....
3v.........
22.........

jumps 2 2 3 2 
