11
11
1
.........22
.........11
........>E3
...........
....J...J..
........1..
...........
1I11J.v1J<2
....S.I.1.1
....>13>I11
....11211..

jumps 3 2 3 2 
