11
11
1
......1.21.
......2.v..
......E.J..
......1.I..
1.....112..
211J.J..^..
2<..J1111<.
.....>1v.1.
.....S.1.1.
....1I12121
....2222.11

jumps 2 2 3 3 
