11
11
1
.21........
.2.>1E.....
231I.......
1111.......
.S1^.......
..J1.......
..1^..J11I1
1.I>1J..>13
213I......2
1<2I.......
.121.......

jumps 2 3 3 
