11
11
1
..221......
..I........
..1v.......
..1IJ......
..I2.......
1.JJ.......
3E<.J......
12^J1......
.1121......
22^S1......
21.32......

jumps 3 2 3 3 3 
