11
11
1
....22.....
....1^.....
....1......
....1......
111JJJJ.JI1
1....1<....
21E1111J1<.
1.11<.^..1.
..S......1.
1121I111I31
111......1.

jumps 3 3 3 3 2 2 
