11
11
1
1123311....
1I22^.1....
1.^...1....
22I2S>3J113
..1.J11J112
......1....
......J....
...........
...........
......E....
...........

jumps 3 2 2 3 
