11
11
1
....21.11..
....2...v..
....2...1..
....2..J>11
.v..J..J1I2
.1..>222I22
.I..J..J...
.1..1......
.1..J..J...
.E..Sv.1...
....121221.

jumps 3 3 3 3 3 2 2 
