11
11
1
11.......12
2IS2222I2I3
.1J.>1J.J.3
..........2
.........v1
.........1.
.E.......v.
.1.....1231
.^I.J11<...
...........
...........

jumps 2 2 2 2 
