11
11
1
.E111.11...
1221<..I...
..1....I..1
2>3J..J<.12
1v3.J.1J111
12^........
122<.......
......J....
.....S1....
.....11....
.....11....

jumps 3 3 3 3 3 
