11
11
1
..12121....
...1.1.....
1112I211J.1
2v<JI2S2222
221J1J.J111
.1.J.......
.1.1.......
.>1^.J.....
...........
...........
....E1.....

jumps 2 3 3 3 3 3 3 
