11
11
1
........21.
........2..
1S1Iv...I..
21<.1...E..
1I2J>>223>1
122..J11II2
........2.2
........1>2
........J..
........1..
........1..

jumps 3 3 2 
