11
11
1
..11.......
..11.......
..J^.......
...1.......
1S2^......1
222J>232J13
1<<.......1
12211<1.J<1
..I........
.Ev........
.13........

jumps 2 3 2 2 
