11
11
1
........E..
........3..
.1111<..3..
.1...1.J<..
.1...1..J..
.v...S..2..
.1..>J.1^..
.I.........
221JJ11v...
311.1..1...
21112122...

jumps 3 2 3 2 2 
