11
11
1
.E21111111.
.3v......1.
.31......1.
.31......1.
.3v....S.2.
.31....1.3.
1^1....1131
21<......^1
2..........
1..........
...........

jumps 
