11
11
1
......1....
11>11>2....
1.....1....
111.>J2<1I1
111IJ.11J.1
1.....1v112
2211J<1J..2
1.JI1S.....
...........
.......>1E.
...........

jumps 3 3 2 3 3 2 
