11
11
1
...23133...
....1.I3...
..>I21J^<..
..I.J.1....
......I....
1.J1<.E....
112J^12v...
..1...11...
..^1112<...
......S....
...........

jumps 2 3 2 2 
