11
11
1
......1211.
.......1.1.
.S....11.1.
12J.J.I^.v.
22..v1<..3.
....1....3.
E...J.J..2.
1....>^JI<.
1..........
2...I......
33211......

jumps 2 2 3 3 2 
