11
11
1
.123.......
...S.......
...2.......
...J.......
...J..>>J1E
...1..I...1
...31v^11<.
...2.1...1.
...^.I...11
.....111122
........121

jumps 3 3 2 
