11
11
1
.....1322..
......I.3..
......1.1..
...>J.J.J32
...v..S1^..
...1....J..
E1.J..I.2..
...2..1.2..
...2..1.J..
...^11<.I..
........1..

jumps 2 3 2 2 2 2 
