11
11
1
......11...
......221>3
.......I..E
.......J...
..S...J1.>2
..1....^121
.12JJ2J2121
.......1...
......JJ...
......I....
.....1331..

jumps 3 3 2 3 2 2 2 
