11
11
1
...1.......
...2..>2223
1I2S11122I3
..v<...J...
..vJ.......
..E1.......
..^1...v...
...1...1...
...1...v...
1223<11<...
...........

jumps 3 3 
