11
11
1
..1122111..
..>>1112^..
1......1...
21..J.J<...
1..........
1v..J......
.>11S......
....1......
....1......
..>2v......
..22E2.....

jumps 3 2 2 
