11
11
1
.......3E..
.......12..
...S...12..
...1...JI..
...1..>^J..
...J....^..
.......11..
......JJJ21
...>J.^.1..
...^11<1311
.......1211

jumps 3 2 3 3 3 2 2 
