11
11
1
...111.....
...v<1.....
...J1I.....
.....1.....
.....1.....
....JJ.....
1v..1......
232E^......
12221SIII21
.11I.1.....
123311.....

jumps 2 3 3 
