11
11
1
..11.......
..^1.......
1122111E...
3<1J>SJ..v.
22^......1.
.1.......1.
13IJ111J1<1
11........1
1.J.J111111
...........
...........

jumps 2 3 2 3 2 2 
