11
11
1
....1111121
....1....1.
....v....1.
....1....1.
11IJ>1J.11.
1..J12211S.
.....J3.I>3
......2...1
......J.J11
......I....
......E....

jumps 3 2 3 3 2 2 
