11
11
1
.....1.....
.....2...1.
.....2S..2.
.....21..2.
.....2J..2.
1>>J.^1..1.
1........1.
2.....J..1.
E.J222<..I.
321...^11<.
1.....1....

jumps 3 3 3 2 
