11
11
1
.13....1...
12^....1...
1>J1E<.J...
.1.....1...
.1.....2...
11.....2...
2^.....S...
1...>11J..1
1.J12I.J111
....^1<....
......11...

jumps 2 2 3 2 2 
