11
11
1
.....1.....
.....2.....
1....2.S...
212v.J.J...
23331J<JJ11
11J111.....
333<.J.....
2..........
1.E1<<.....
...........
...........

jumps 3 2 2 3 2 2 2 
