11
11
1
...11...331
...11I11I31
...1....32.
..13S1J.^2.
...J.....2.
.........2.
...1.....2.
1vJ<.....2.
.1.......2.
.1.......^.
E1.........

jumps 2 2 2 
