11
11
1
...........
...E.......
...1.......
1..........
31.J..J....
311J..21Sv.
33332<1.11.
1.....1.11.
1.....11<v.
11111111<1.
........11.

jumps 2 3 3 
