11
11
1
1321.......
1I.1.......
2S1v.......
1I.J.......
12.........
12.........
12.J.......
1I.........
3E<........
233<.......
.11........

jumps 3 3 
