11
11
1
....1E..21.
2111^...I1.
211.....^1.
..1.....1>2
112..J.J112
111.....J..
........1..
........1..
........2S2
.......>2.1
......1232.

jumps 3 2 2 
