11
11
1
...........
1I1222<....
1E.1.......
11.J1.JS...
.1.........
.1.........
.111.......
.11J.......
.1J..J.....
122212>v...
23321321...

jumps 3 2 2 2 2 
