11
11
1
....1222...
....v311...
....I^221.1
....1.I...2
....>1J.J12
...>J..J1E1
........1..
...J..J.1..
...1..>1211
..S^..^.1.1
..11....111

jumps 3 2 3 3 2 2 
