11
11
1
13E........
122........
13S........
.^1........
.^1........
.1>J.......
.1.........
23<J.......
3^J221J1I21
22<1.......
...21......

jumps 2 3 2 2 
