11
11
1
.......1111
..>33323222
..I..E.1..1
..^....>112
.>211v....1
.I1..J.....
.1.........
.1v1..J.JS1
.11........
.11........
.11........

jumps 3 3 2 
