11
11
1
....11.....
2I33<1...>2
1....S..121
32JJ2<..11.
11111J..2^.
........1..
........I..
........1..
........v..
........1.1
........1E3

jumps 2 3 3 
