11
11
1
..E1.......
...1.......
.>23v......
.2.2I......
.3S^3......
1^1.2......
112<vv.....
..I.J2.....
.>1..2.....
.1...2.....
.111231....

jumps 3 
