11
11
1
.......121.
.....>123>E
.....1.1^33
.......1>33
.......1.11
.....J.1.^.
.....S.J.1.
.....^...1.
.......1.I.
.......3>1.
.......21..

jumps 3 3 
