11
11
1
.......3E21
11I1>Iv^.11
2..11J1^.S1
21..J.IJ111
......J....
...J.>1v...
...11I11...
.....11....
.....11....
.....11....
.....231...

jumps 2 3 3 3 3 
