11
11
1
..1..231...
..I.111....
..J.21I....
..1.J11....
..2..SJ....
..I.J3<...1
.>3J<331J.2
.....^1.EI1
......J....
......1....
......1....

jumps 2 3 2 3 2 2 2 
