11
11
1
....32332..
....3.1.1..
....I.v1<..
....I.J....
....J......
......J....
......2....
....J.J....
....S......
....2.>32v.
....2.1..E1

jumps 3 3 2 3 3 
