11
11
1
.........21
.....v<1.31
.....2.^131
.....J...21
.........I1
.....>J..E2
111.J..J112
222J..J.222
1.JS.......
...........
...........

jumps 2 3 2 3 3 2 2 
