11
11
1
....13221..
.....1.1...
.....1.S...
.....J.....
.1..J......
2<112J.JII1
1121v<.....
..1.J......
22^JI1.....
1...1I.....
....E1.....

jumps 3 3 3 3 3 2 
