11
11
1
12.........
12.........
1I.........
22>I1v.....
3<<..J1.J21
1........1.
........v21
.....v..E11
.....>1SJ22
.......I.1.
.......122.

jumps 3 2 2 
