11
11
1
.......1221
.......1v.1
.......12.E
.....S.^3<.
.....I..1.1
2v>1JI.J^12
3I2JI<1JI11
.11........
.1I........
.11........
.11........

jumps 3 3 3 3 
