11
11
1
....12122..
.....v^22<.
.....3.1I1.
.....3.>I31
.....E..1..
.....1..1..
.....1..1..
1I1JSJ11v..
.....1..J..
.....I..1..
.....1..1..

jumps 3 3 2 
