11
11
1
..111......
..>22111...
..J....I...
..S....1...
1231J1I2Iv.
112.J.>J121
E.....^..1.
2........1.
2.....Jv1<.
1.....11...
......11...

jumps 2 3 2 3 2 
