11
11
1
..1131.....
..v131.....
..J.1......
....J11<...
..J.J......
..1........
..3.J..J...
..I....I...
..3....1...
..3.>1SE...
..321.23...

jumps 2 3 2 3 2 3 
