11
11
1
...........
.......S...
.....1v<...
.....2v....
.....23J...
2I11<3<....
2....v.....
22E..J.J...
1......1...
211111>2v..
21....122..

jumps 2 3 3 
