11
11
1
121........
.^1........
.1v2S22<...
.1I........
.1J........
.1.........
.12...>J..E
.1J........
11J<..J....
323211^....
3221.......

jumps 2 3 2 2 2 
