11
11
1
E1.........
3..........
23<........
..1........
..1........
111.v1.J<S.
23J.J..J222
..........1
..........1
1I2I2111>11
...........

jumps 2 2 3 3 
