11
11
1
......E1122
.......>2>2
1.......1..
3S1J122<1..
11......1..
.1......1..
.I......1..
.1......1..
.1......1<1
1II1>111111
22.........

jumps 2 
