11
11
1
...1331....
....2^1....
111I2I1v..E
111J1Jv2111
..>1^JJ1...
..1....J1S.
..1........
..^..JvJ...
.....^1I...
.....11^...
.....11....

jumps 2 2 2 3 3 3 2 
