11
11
1
...111..11.
1S1v.v..^1.
...J.1..^21
122J.1J..>3
..1v.1..E12
1..1.I....1
32JJ1<.....
...1.......
...I.......
...I.......
...1.......

jumps 2 3 3 2 3 
