11
11
1
.......111.
.........1.
11>11J.J.21
1......1.>2
1S.....^112
......J1<11
...........
......J....
3<111<v1...
2I1112EI...
.....231...

jumps 2 2 2 3 
