11
11
1
.....112...
.S...12^...
.I....J..v.
1<...J...2.
111>2v1..2.
.....21..2.
.....JJ.1E2
....J....^2
....1J.....
....1^I....
....111....

jumps 2 3 3 3 3 2 
