11
11
1
..132......
..131......
..>E2......
1..3J.S....
2>1^1.1....
1...^.1....
11I1<.J....
....J......
....^12II<.
......1..1.
.....12111.

jumps 3 2 2 
