11
11
1
...........
.......S...
....J.v1...
....^.1J1..
....2.J.1..
..>13J..^..
12E.1J.>11.
..^.JJ2111.
....1.J.11.
....I...11.
...23121121

jumps 2 3 3 3 3 2 3 2 
