11
11
1
1..........
21112S<....
1...1.I....
111Jv.^....
....J......
....12<1112
.....J....3
....1.....2
....E.....1
....2I....1
....3322111

jumps 3 3 3 
