11
11
1
...........
12EI111<...
.v.....1...
.2.....1...
.21..J12I12
.31J>J.J<23
.2..1...1..
.2..1..JS..
.>222J.^...
...........
...........

jumps 3 2 2 2 3 2 
