11
11
1
12...231111
.211122>1I2
.^...v....1
.11112<....
.....2IJ...
.....2S....
.....^11...
111..JJJ...
2E....1....
1.....1....
......1....

jumps 2 3 3 2 
