11
11
1
2E1........
1^.........
221J12222I1
2.J..J1<...
1..........
.........S.
.......J.1.
.......^1I1
......>1J22
.........>2
.........12

jumps 2 2 3 3 2 
