11
11
1
...12331...
...2I^1....
...11.1....
...^J.J1<.1
...J..12212
....J..J..3
......J...2
...J.......
...1.......
...Sv11....
.E13321....

jumps 2 3 3 3 3 3 3 
