11
11
1
..1221.....
...1I......
...11......
...1.......
...J.......
....J......
...>212<...
12I1J.JJ222
....^...E11
....1..v1S.
....123322.

jumps 2 3 2 3 3 
