11
11
1
.......1...
.......2...
.13333<1...
..I....J...
23<....J...
1.....JS...
1111J.I211E
......^I1<.
.......>331
........v1.
........11.

jumps 3 3 3 3 
