11
11
1
.......1221
........111
....E2<..v3
........J33
111>11J.1I1
11..J1S..v1
......1..I1
......11121
.........11
.........>1
...........

jumps 2 2 3 
