11
11
1
11.........
121<1111111
1v11123<J12
23J.1>S2J.2
.1.........
.v.........
.3.........
.2.........
.1.........
.1.........
1E.........

jumps 2 2 2 
