11
11
1
...........
...........
...........
...........
.........S.
.........1.
.........1.
.........11
1v2222<22<2
23E.1>11132
12321.1332.

jumps 
