11
11
1
.........23
..v1II11122
..3.....S31
123JJ22<...
E3<........
.I.........
.1J........
.v1........
.11........
.vI........
.31........

jumps 2 3 2 
