11
11
1
...12111...
....1111...
....J..I..E
.....JJJ..1
....>1^...1
11J.1J1<111
.....J.^...
...vSv1<111
...I.J.1111
...21212...
...1.1.1...

jumps 2 2 2 3 2 3 3 2 
