11
11
1
.......112E
.......S3^.
.......33..
.......33..
.......J3..
........3..
.......J3..
......>2^..
......12v..
......13I..
......122..

jumps 2 3 
