11
11
1
.....1.....
.....1.....
.....J.....
333<.J....E
3>>^.S.>111
2I...J.1...
121IJJI^...
.1.........
12<1.J.....
12...2.....
.1...2.....

jumps 2 3 3 2 3 2 
