11
11
1
231.....1..
231111112..
.^1S....1.2
.v111..J213
.1......>11
.1.........
1v.........
1>2J..J..1.
.........1.
.......1I1.
.......E...

jumps 3 3 3 
