11
11
1
........1..
........2..
........2..
........2..
........1..
.......SJ..
...>J.J3322
....>1JJ3>2
....>21J2E3
........111
......12231

jumps 2 3 3 2 3 2 
