11
11
1
...11233...
..1I<1.1...
..1I1v.1...
..1S.>vJ...
.>I2v.v....
13<.J.J....
...........
....J......
...E2.1....
...^2.1....
...1321....

jumps 3 3 3 2 
