11
11
1
E121.......
..2I.......
..S1.......
..31.......
..3J.......
1I^....v..1
1.J>J123113
.......1..2
.......2I33
........122
...........

jumps 2 2 2 
