11
11
1
....211E1..
....3^.3...
....31.1...
....3..J...
....S.J^1I1
....JJ.2...
.....1.^...
.....IJ....
....I11....
....22^....
....33.....

jumps 2 3 3 3 3 
