11
11
1
.....111...
22222311...
1....2.....
11..SIJ....
12.J12.J...
.1...1.I...
.1...1.^...
.>1J.1>J.1E
.....I.J..1
.....1.1...
.....122...

jumps 2 2 3 3 2 2 
