11
11
1
....13.....
....13.....
11J.Jv.....
1....J..v11
1...J..J1.1
1....J..1..
2..J<3S.>12
1.....211I2
.....JE....
.....^I1...
......11...

jumps 2 2 3 3 3 2 3 2 
