11
11
1
.........11
........vI1
........11.
........1S.
........1^.
......J.J11
..........2
......>JJ13
1I1J.J1E.>1
2223111.11.
32.1....11.

jumps 3 2 3 2 2 2 
