11
11
1
..1.1......
..1.2......
21J.v......
213JJ1SI113
..^.JJ.J323
....J......
....J......
....2>1J..1
....J.....E
....1......
....1......

jumps 2 3 2 3 3 2 2 2 3 2 
