11
11
1
...........
...........
...........
111v.......
1>SJ..v....
1.....1....
3E<J..J....
1I.1J..J223
1IJ1......3
...>3321112
...........

jumps 3 3 3 3 3 2 
