11
11
1
........11.
...11<1111.
...J...111.
.......12I1
...1..SJ^33
...v...>233
...2J....>1
...2.......
...2v......
...I2......
.1E32......

jumps 2 2 3 
