11
11
1
..1121....1
..1.^3<1<12
2221J.J.112
211>J..J.v2
11..JS...1.
.........1.
.........1.
.........1.
.........1.
......v1I21
.....E1..11

jumps 2 2 3 3 3 
