11
11
1
.....123211
211112122I1
2IJ.IJ.^1..
........1..
.....1.....
.....v..J..
.....>J.122
.E1.J..JS22
........^11
...........
...........

jumps 2 2 2 3 2 3 
