11
11
1
...E11.....
...I.^11<..
...2.......
...J....J..
........1..
..>J..I1^..
..12.......
..11...v...
..1J.v131<.
..11.212.S.
..132233.1.

jumps 3 2 3 2 
