11
11
1
...1...1E22
...2....1.1
...2....J..
1..J....2..
2I1JS<..^..
....1...1..
...J1...1..
....JJ>I^..
.....11....
...1.11....
...1331....

jumps 2 3 2 3 3 3 
