11
11
1
...........
...........
111111111<.
1111J..J.21
E11<1..J1I1
.>S1J..1.^1
.......J..1
......>1112
......I...1
......^21<1
.......1133

jumps 3 2 3 3 3 
