11
11
1
..11121....
..1..11....
..1...111v.
..1......1.
..^<.....1.
311^.....1.
ES1JJ11J232
222<.....11
...........
...........
...........

jumps 2 3 3 
