11
11
1
.....133221
.....11E1<1
.....1J1II1
......J....
.....J^.1..
.....^..1..
.....Sv.J..
...11J1.221
...1.1v....
...1.1I....
...11221...

jumps 2 3 2 2 3 
