11
11
1
........131
........1^1
..11v111<1.
....2....^.
..J.2..11^.
..^1S......
1.J.J.....2
1>11J..J..3
....1..1..1
....1..1..E
....11121..

jumps 2 2 2 3 3 
