11
11
1
...........
...........
...........
111I>1J<1<.
221J.1J11<.
11.........
.I..J...v..
1322^JI1S..
.1......3<1
.I.....>321
.1E......1.

jumps 3 2 3 3 2 
