11
11
1
....131....
.>112^.....
.211v......
.2S.J......
.1..1......
.^.........
.I..J......
1211.>J1122
232<E1....1
....v1.....
....11.....

jumps 3 2 3 
