11
11
1
......221..
......3....
......2J...
......J^...
...>1JJ3<..
...v..J3I11
...3SJ.3211
...2...3...
..EJ..1^...
..11.......
..12.......

jumps 2 2 2 3 3 3 2 
