11
11
1
1231.......
123........
.1IJ.1v....
1I>3vSJ....
23IE2J1....
....>v2....
...J.J2....
...1..^....
...1.......
...^<1.....
....11.....

jumps 2 2 3 3 3 
