11
11
1
......1123.
..v11<<..I.
..I......3.
..J......3.
.........2.
..v......I.
..1..S...1.
..1.JJ.J.^.
..v.1.....1
.>212211I12
.11.1221..E

jumps 2 3 2 2 
