11
11
1
1211.....11
1^Iv...vSE1
11vJ...1v2.
..>2IJ.J3^.
........1..
.......JJ..
...J....1..
...2<...2..
...21<1<^..
...2.......
..12.......

jumps 2 3 2 3 2 3 
