11
11
1
.......11E1
......>II21
1111<11<1..
1>1v..J.1..
...J..1.1..
......SJ^21
......^....
1112>J1.J11
1<I<.......
...........
...........

jumps 2 3 2 3 2 
