11
11
1
...........
.......v...
1......2...
2......1...
2.111..J...
2121111J..1
EI<1..J2II1
1S>J.2>^...
..1..I.....
..1..1.....
..1111.....

jumps 3 3 3 2 
