11
11
1
.....13321.
......21.1.
....v1E3232
....3JJJ.^1
....2....1.
....J..J.1.
.....JJ..I.
....J1.>1^.
.....1J....
.....1S....
....111....

jumps 3 3 2 2 2 3 3 3 2 
