11
11
1
......232..
......1I3..
......1J^..
......1.1..
....>1^J21.
.........^.
........J^.
.......J21.
........I1.
.......>S31
.......E31.

jumps 2 3 2 3 
