11
11
1
..13222....
1..3..3....
32<<..E....
1221J.2....
22vJ.......
21>^.......
11.........
11.J.......
1^.S.......
...2.......
...1.......

jumps 2 3 3 
