11
11
1
....1321231
.....^2233.
.....S..13.
........J3.
........1I.
........I3.
........^3.
.........3.
.........3.
.........IE
.........21

jumps 2 
