11
11
1
...........
.1....v....
.I....J....
.2.........
.2....J....
.I.........
22.........
22>332JE121
.1.S113221.
.111113....
......2....

jumps 2 3 3 
