11
11
1
...11122.E.
111I111<.1.
111I1J.1121
...JS..1121
.......1.1.
.......J.1.
.........I.
.........1.
......13J22
.......3.I1
.......2.11

jumps 2 3 3 2 
