11
11
1
...111.11..
...I.1..1..
...v....1..
...>JJ.J>I3
.......^112
..........1
.....J....1
.....1....1
1...vSJ1<11
211132.....
111E21.....

jumps 3 2 3 3 2 
