11
11
1
....E1.....
....1......
....1......
....J......
....^..J<..
....I......
....1...J..
1...J<..1..
2SI223v.^..
23I<112.1..
...1112121.

jumps 3 3 2 2 
