11
11
1
...........
...........
...........
11v........
1.J<S......
....J.....1
122JJ.J12>3
..JJ.>1E323
..122^.J111
..^1111^...
...11111...

jumps 2 3 3 3 2 2 3 2 
