11
11
1
..2321133..
..1....E3..
..^S...22..
.......31..
.......Iv..
.......11..
.......J>11
.......2vI1
.......^3..
........2..
......122..

jumps 2 
