11
11
1
...........
......>11v.
......1..1.
.........1.
....Sv..1<.
.....JJ.2<1
......1.>E3
......1.11.
.....JI11v.
......12I1.
....133321.

jumps 3 3 2 
