11
11
1
..111......
..v.I......
..1.1......
..1........
..1........
..>JJ.>33E2
...........
..v>J.J1111
..1.1...S.1
..1>321II11
..2211111..

jumps 3 3 2 3 
