11
11
1
...........
...........
.........>2
.........^2
.......v132
.......vS^2
.......1..2
1......1..2
32J.1113I22
2<11I112...
1.....E21..

jumps 2 
