11
11
1
...........
..........1
.....v1.J<3
11..JJ.J1E2
2........S1
2........2.
111J.211131
.....1...^1
.....1...^1
.....11I121
.........11

jumps 2 3 3 3 2 
