11
11
1
..111......
..1I211v...
....S..3..1
.......I..3
122E1.>J113
......1....
......1J...
......1I...
......13...
......13...
......12...

jumps 3 2 
