11
11
1
...1..E....
...2..1....
..J211^...1
1>2vSJ.J.12
1.12......1
111JJ.J.J11
..11.......
..1^11JJ121
..121^.....
..^v.......
..11.......

jumps 2 2 2 3 3 2 2 3 3 
