11
11
1
...........
...........
...........
...........
...v..J.J23
...v.....>3
.1.J..E...1
.2....^...2
.2..11^..>3
3S1221Iv.11
22.11..211.

jumps 3 2 3 
