11
11
1
11.12231...
1Iv1..21...
.111..II...
.1J1..J112E
.S.1...>1I2
..J1..J....
...1..^....
..11.......
..11.......
..11.......
..11.......

jumps 2 3 2 2 
