11
11
1
1E111121...
.1....^....
.......J...
.SJ.J.1v111
.......2.>2
.>11J..J122
.......I.1.
.......1.1.
.......3.2.
.......I>^.
.......21..

jumps 2 2 2 3 3 
