11
11
1
...........
...........
...........
.v.........
.2...v.....
.I...2.....
.2...2.....
23<..>v....
EII31JS22..
21...12.2..
21...12.1..

jumps 2 
