11
11
1
23121......
EI121......
.^<2Sv.....
23<22<.....
11.^1......
11.1J......
22I^.......
11..I......
.I..1......
.1.v1......
.111.......

jumps 2 
