11
11
1
.132132....
..1........
..1........
..1>>JJ11<.
..1......1.
..J......21
.........S1
..I......2.
..1......2.
11v1.....2.
12E1.....1.

jumps 3 3 2 
