11
11
1
121........
.1v.....Sv.
.11...E..1.
.I1...^..1.
.^1......1.
.11......1.
1I<...J..1.
1I11>J.v231
.1....J1.1.
.13<112<I<.
...........

jumps 3 3 2 
