11
11
1
......1211.
.......1.>1
122221J23I3
........I.2
E<111..J<11
........J..
......>1^..
......1....
.....S1....
.....11....
.....11....

jumps 2 3 2 
