11
11
1
..12131....
..1v.2S....
..1J.J.....
..1J.J.....
..v1.2.....
..JJ.I.....
...^.2.....
..12.1...E.
..12.J...^1
..13>211111
...222.....

jumps 2 2 3 3 2 2 2 
