11
11
1
...........
...........
...........
...........
1.JS.......
1......v...
11>Iv..2...
....J..2111
1v111J.2111
3EI2<v.1...
23212211...

jumps 2 2 2 
