11
11
1
....11.....
...v<2<....
.>33J11....
.1.J1J....1
.^112..J233
121JS2>1111
...I.......
...J.......
...1>>E....
...1.......
...1.......

jumps 2 3 2 3 2 3 
