11
11
1
....1113...
.>11III^...
.2..I......
.I..v......
.3..J......
.3.........
.3.......E1
.3..>11>321
.S<....11..
.1.....11..
.......11..

jumps 3 
