11
11
1
E......32..
1......3I..
1......3J..
1......3...
111..J1S1..
.......I1.1
.......^212
.....J11322
........1.1
........v.1
........211

jumps 2 3 3 
