11
11
1
...111.1...
...1.1.2...
...1...J...
...11....>3
....>J.J223
E3<J1S.....
3.^112<1...
.....^.^...
...2>1.....
...2.......
...1.......

jumps 2 3 3 3 
