11
11
1
.22.111....
.^21<......
..I.......1
13<...J.112
.1.>1J11J.2
.v.S......1
.1......J..
1<....J.v..
1.....1.3..
1.....1.3..
E....1212..

jumps 3 2 2 2 3 
