11
11
1
...111121..
....>E.^1..
...J....1..
1<I2..J1<..
2.....1....
212SJ.JI231
...J.......
......J....
...J..2....
...2..2....
...1..1....

jumps 2 3 2 3 3 3 2 
