11
11
1
...11......
1..11......
2S<v3I<....
211J1122<..
1...J......
E1.J<......
...1^......
...22......
...22......
...22......
...33......

jumps 2 3 2 
