10
10
1
122...1232
..S.....11
12322222E1
..1......1
..1......1
..11IJ.232
..........
..........
..........
..........
