11
11
1
.......11..
.......E1..
...1S2J1321
...J1......
...........
...1.......
.>J1J..1111
.1.J.v111I1
.1..J3.....
.^1<1I.....
...11321...

jumps 2 2 2 3 3 2 
