11
11
1
.....3E31..
11<..^.2...
112I1v.I...
.....1.J...
..J..J.....
..I.S......
....1J.>J.1
..J..^....2
..^v.JI1113
..11.....>3
..11......1

jumps 2 2 3 2 2 2 2 
