11
11
1
...........
...........
.1.........
.2.........
.2.........
.2.........
.2>>111v...
.2S....1EI1
.33....12.1
233..>22311
332.....1..

jumps 
