11
11
1
...........
...........
...........
...........
...........
...........
.11........
221........
44444467631
421121E2311
3S322112432
