10
10
1
......121.
.......1S.
1......12.
E.12222342
1111111233
......1242
......114.
......114.
......114.
......1241

jumps 
