11
11
1
11111211245
1....2....4
11112521114
221.1S1...4
211.111111E
211.......4
222.......3
111.......2
..........2
.........12
...........
