11
11
1
12312333343
..3......12
..3......12
.1311111112
.11.......2
.11.1111113
.11.1.....3
.S1.1111113
..2E1111112
..211111111
...........
