10
10
1
...221....
.S1322....
...212....
...212....
...212....
...212....
..E212....
1223452221
12..23....
121122....

jumps 
