11
11
1
..........1
..........2
..........2
........1.3
....1111314
....1...324
....1.11313
....11S3566
.........25
.........14
.1E33212344
