11
11
1
...........
..........1
.....S11113
..........3
35322222224
......12223
..........1
.......111E
.......1..3
.....112114
12234423444
