10
10
1
.114233E1.
11.411....
2..411....
33S6331...
...411....
...311....
...211....
...211....
...211....
...111....

jumps 
