11
11
1
........1..
........E..
........1..
.....v.>211
1111IS1^211
1111v^1.I..
....1.1.2..
....v.1.2..
....1.I.2..
...1<.1.^..
...1111....

jumps 
