10
10
1
...121....
....1S1111
....121111
.11112....
2432132221
1222232242
.....1..E.
.....1..1.
.....3111.
.....2....

jumps 
