11
11
1
...1.......
11>2.......
3IJ3S3<...1
2..>JJI333E
1.....1....
...........
....I......
....1.J....
....J.1....
......1....
....221....

jumps 2 3 2 3 2 
