10
10
1
21....1211
3433444432
.1..1.....
.1..1.....
11..1.....
22111.....
11S.......
1221111...
.12...E...
.34...1...

jumps 
