10
10
1
..141.....
...4......
...4......
...4......
1..4......
21151.....
1S1E211111
1116211111
..15......
.1351.....

jumps 
