10
10
1
1.41.21.11
2272231121
..3..1..1.
..2..1..1.
..E..1..1.
..1..1..1.
..2111..1.
1242222S2.
..2.....2.
..1.....1.

jumps 
