11
11
1
..111..1132
..212112121
..2.1..1121
..211..1112
..221..11.E
..121..1212
...21.13321
.1243222232
...1....112
...1....1S1
...111111..
