10
10
1
.131......
..2.......
..2.......
..2.....11
1242222232
..32222232
..S1111123
..2.....1E
..2.....11
..1.....22

jumps 
