10
10
1
....22....
...111....
...2S1....
...221....
2..221....
4224432221
211321....
1..211....
111321....
...2211E..

jumps 
