11
11
1
...........
...........
...........
...........
..........1
..........2
......1345E
.......1110
.......1..0
.......1.20
..1344S7800
