10
10
1
.......122
......1213
....123323
......11..
......S1..
......21..
......21.1
12234E5433
......21.2
......2212

jumps 
