11
11
1
...........
...........
.Sv........
21I........
2I1........
211........
311........
311.......1
222>1>333E3
.11.......3
.11......13

jumps 
