10
10
1
....12....
....13....
222S252222
1....3...1
.....3....
.....3....
.....31111
1222242225
.....2.E14
.....1....

jumps 
