10
10
1
2..12121..
31112E3211
1...1121.1
1111223211
....11S1..
....1111..
....1111..
....1111..
....111221
...132.11.

jumps 
