11
11
1
..........E
..........1
..........2
11221111114
1.........4
1.........4
1.........4
11333211S15
12444432325
121.....1.3
122221..112
