12
12
1
122222223332
1344553233E2
111111.....1
111233221112
....S112...2
.......22443
.......1.1..
.......1.1..
.......111..
............
............
............
