11
11
1
.....22..2E
11<..231132
111113^..2.
..J..2...2.
..I..J...2.
..I......1.
..I..J.....
..1..2.....
..1..3.....
..S..^.....
..1........

jumps 2 3 3 
