11
11
1
...1..111..
...2..1.1..
...2v121I11
...1v11.^12
...I111...1
...11S1....
...123<....
....12.....
....E2.....
....22.....
...132.....

jumps 
