10
10
1
......11..
......11..
......11..
......1E..
......12..
1S11112312
......12.2
3222223411
4332222311
111....1..

jumps 
