10
10
1
.1........
.2........
.2........
.2........
.2........
.2........
7311111111
0721E22211
26...S.1..
46...111..

jumps 
