10
10
1
...E11....
....22....
....32....
....22....
....12....
....12....
111124222.
1....323S2
1....2..22
1112211452

jumps 
