12
12
1
232111112464
1.1222222211
1.....11...1
1.....11...1
1.....111333
1.....1..1.2
1111111....2
...........E
122321111..1
...1....1..1
1112S...1..1
111112222111
