10
10
1
652....253
E1......11
5S33332121
31......1.
2211111121
........11
........11
..........
..........
..........

jumps 
