11
11
1
...........
1..1<......
22233223<S.
...11..1...
...11..1...
E11<1..1...
.v11II1<...
.1..1......
.I..1......
.1..1......
23122......

jumps 
