11
11
1
32....132..
3I11>1221..
22<1112<1..
11.....^1..
........I>1
.......J221
........11.
......>12^.
......S.J..
...........
........E..

jumps 2 2 
