11
11
1
........131
111111112I1
222S2333<^1
2..........
3..........
2..........
3E<........
1..........
...........
...........
...........

jumps 
