11
11
1
221........
3<.S.......
21v1.......
2.>J..J<<21
1..........
3322J.>v...
1I<<...J...
.......I...
.......1...
.......E...
.......1...

jumps 3 3 2 3 
