10
10
1
1E..11..43
111121..31
1S11321241
1...21.12.
3222321232
1...11.132
........2.
........1.
..........
..........

jumps 
