11
11
1
......11...
3333<12<...
3222^.1....
1.....^....
1>11112v...
......11...
......I1S..
......^2<..
.......1...
......12...
.......111E

jumps 
