11
11
1
..11...122.
..1^....1E.
..I1.....^.
..11....J..
1v11....1..
12<2....1..
.1.3....1..
.1.^S...1..
.I......I..
22I11I1v1..
21.....11..

jumps 2 
