10
10
1
.......1..
.......2.1
24E455S643
......11..
......11..
....122212
.....11212
.....112..
.....112..
.....122..

jumps 
