11
11
1
......311..
......^.1..
......1.1..
......1.1..
......1.I..
31<1<<1.>I1
3....12...1
1....S3...2
1.....E...2
1I>211^1<11
...........

jumps 
