11
11
1
....1211...
....23.1...
....2^.1...
.v..2^<J...
.2..^.1....
.2....1....
.2....11...
.211IJ^>E32
.^.J.J21111
......S....
...........

jumps 3 3 2 2 
