11
11
1
...........
3221......1
3v112222222
22SI2......
1E..1......
1...1......
1...1......
1..>^......
1..I.......
1>1^.......
231........

jumps 
