11
11
1
12211......
232.1......
221.1......
2^21<......
112v.......
..11.......
..E1..S...1
..21..11112
..^<1I1I111
...........
...........

jumps 
