11
11
1
1233121....
3I3E3I<....
1..2.1.....
11.J.JJ1S..
...........
...J.......
.....J.....
...J.......
...2.......
...2.......
..12.......

jumps 2 3 3 3 3 2 
