10
10
1
.2..1.....
14..2.....
34113111..
E3..2..1..
12..2..1..
.1..2..2..
1222411S..
....3..3..
....3..3..
....2112..

jumps 
