11
11
1
E1.........
.1.........
.1.........
.1.........
.1.........
.1........1
.1......>>3
.I.S....1.1
.I.>11112>2
12111122323
11...2322.1

jumps 
