10
10
1
.37551....
..412.....
..411.....
..411.....
..411.....
..4111S222
..31.....1
..21......
..21......
.1E3......

jumps 
