11
11
1
...33......
...11......
1<1233<....
2...1......
3v..E......
12..2......
1>22^......
1.1SJ..J..1
111.J11.J11
...........
...........

jumps 3 3 2 2 
