11
11
1
......11...
....E12I112
11111SJ^333
1..........
3<.J11211<.
......1..1.
......J..1.
.........1.
......>1>2.
......2....
......1....

jumps 2 2 3 
