11
11
1
...........
...........
...........
1v.........
1I....S2<..
11Iv..I....
222<<<1...1
1.>112211E3
21^..11..12
1....I1..11
.....11.121

jumps 
