11
11
1
......12121
......12.1.
......1I.1.
......1J.^.
......J1>^.
.......J1S1
1221J.1J123
......1J.12
......JE...
.....1.^...
.....221...

jumps 2 3 3 2 3 3 2 
