11
11
1
...........
...1E33<...
.......1...
.....v12<..
.....1.11.1
11<I1I1IS13
1111I>23112
.......2...
.......2...
.......2...
.......1...

jumps 
