11
11
1
...........
...........
1<.........
21.........
21.........
21...>E3322
3S111^I3<I2
1.......^.1
........1.1
........^11
...........

jumps 
