11
11
1
...121.....
..v12<.....
..J......1.
.>2S>J..12.
..J.J....1.
.........v.
..J......3.
...EJ....3.
..JI^....3.
..v11....3.
.131122112.

jumps 2 3 2 3 2 3 2 
