10
10
1
.242......
..11......
245E554332
....S...11
1...1...1.
21111...11
3211111122
1.......11
..........
..........

jumps 
