11
11
1
...........
.....>v....
......1....
.122EJJ....
.....I.....
...........
...........
1....J.....
22vJS32JJ<.
233113222I2
..2211....1

jumps 2 2 3 2 2 2 
