11
11
1
.....231...
.....1^E...
.....1.....
.....1.....
.....I.....
.....2I1I11
.....2....1
1....I....1
21111312<<1
1111>S<1111
.......1111

jumps 
