11
11
1
...1...1111
...2...1.12
...2...1.13
...S...1.>3
...I...1v11
...>1I121..
.......I1..
.......21..
.......21..
122<<1131..
..E....1...

jumps 
