11
11
1
..11.......
..1S.......
..1.......1
..1.......2
..v......12
2I3v...>233
1.J>3J.J12E
..1......11
..2........
..2........
.12........

jumps 2 2 3 
