11
11
1
..12.......
..1I.......
..13.......
..vIv......
.SI32......
..111......
..I11....E.
1.1^<....1.
212<.....1.
1122>1I112.
..11.....21

jumps 
