11
11
1
...111.....
...I.1...>2
...1.I11121
.....vE..1.
.....J...I.
...J.....1.
...1.....1.
..S^.1...I.
2I2^.1...1.
2<222311.1.
.22..1.111.

jumps 3 3 
