11
11
1
....121....
....121....
..S.I11....
.>212I3<...
.11...1....
.11..v<....
.1I..2.....
.^2..I.....
.13..3.....
.13..3.....
.12..2E....

jumps 
