10
10
1
121....12.
E211111351
2111111462
111111132.
.......S1.
.......31.
.......31.
.......31.
.......31.
.......21.

jumps 
