11
11
1
...12...221
...11...2..
...1J...2..
...>11J.21E
....J...1S1
....2...J1.
....^<..11.
.....^..11.
.....1..J1.
.....^<.11.
......1231.

jumps 2 3 2 2 2 
