11
11
1
...........
...........
...........
...........
...........
.........v.
......v<.2.
.>IEI<11.2.
1....^2212.
2S111121.1.
.....13211.

jumps 
