11
11
1
......12321
........31.
1>1S1111^1.
1..1.....1.
11I<.....1.
.........1.
1........I.
E........1.
2........>3
2I11I1I1122
...........

jumps 
