11
11
1
..........1
.......>3I3
.......S..1
....1I<I111
11113222<..
2...2......
311<2......
21122......
1..^2......
E...1......
...........

jumps 
