11
11
1
..1........
..I........
..2...S....
..I...1....
11J.Jv1J121
.>^..11....
.1...J1....
131IJ2<J1<.
....1J.v...
....1>v1...
...121E2...

jumps 2 3 2 3 3 2 2 
