11
11
1
.1112......
.1..2......
.1..1......
.1..1......
12113ISI<..
2^..1......
1...1......
..>221v....
......3...1
......2I112
........E11

jumps 
