11
11
1
...........
...........
...>11I1111
...I.....11
...I...v11.
...1v23<...
...12..S...
...I2..I...
..v33..2...
..I12..2...
.E222..1...

jumps 
