11
11
1
.....1.....
.....2.....
.....2...S.
.....2...1.
.....2...I.
.....2...v.
.....I.>121
.....2I2v21
.....1.^3<.
.....1.13>E
.....1122.3

jumps 
