11
11
1
......E2...
......1....
1>1J.11....
1..........
1..J..J1I11
111JJ<.J.11
111112<.S..
.....>v.1..
.....1J.1..
.....1v.1..
....1232221

jumps 2 3 3 2 3 2 2 
