10
10
1
322.......
33E211....
.....1....
..S..1....
1122232221
1111121121
.....21121
.....2..12
.....1..15
........25

jumps 
