11
11
1
.1121122...
.1.31..1...
.1.I1..1...
.1.Iv..J...
1<.1J......
111JJ.v....
....1.1....
...JS.J....
...IJ......
...3.......
...32.E1...

jumps 3 3 3 3 2 3 2 
