11
11
1
1......1121
2......2131
2I1>v..^231
1111E111<1.
...S.....1.
...1.....1.
...1.....I.
...1.....1.
...1..111^.
...1>v1....
...1111....

jumps 
