11
11
1
..11E....22
11I1v<...11
1.J.22>32>2
....J^S...1
......v1111
......J....
....J......
....2......
....I.v....
....2.1....
....111....

jumps 2 3 3 3 
