11
11
1
.......111.
...S1I12.I.
.......2.1.
.......2.>2
...11112..2
...1.E231<1
...I..12...
...^1<12...
.....112...
.....1v3...
.....123...

jumps 
