11
11
1
...2321....
...22......
...IS......
...EI1v....
...1^I32<..
......I12..
1222223>^..
...........
...........
...........
...........

jumps 
