11
11
1
E121232....
..^..12....
.....J^....
....JI.....
....12.....
.....2....1
.....S11112
....JJ....1
...v1^1.J23
...211....1
...2221....

jumps 2 3 3 2 2 
