10
10
1
.......531
...1...6..
...2...5..
2E5S2114..
1..1...3..
1..1...3..
2..1...2..
21121111..
3211......
1.........

jumps 
