11
11
1
..1111.....
..1..1....1
..1..J.E212
11^.......1
1....S....1
11..J3<...1
.....2..>21
.....2J.^..
.....21.1..
.....>3131.
......112..

jumps 2 3 2 
