11
11
1
........1..
..v....S2..
..I.....I..
1<31I111<..
1.2........
2E2........
1.1........
3231.......
3.I........
323222<....
111........

jumps 
