10
10
1
3821......
10........
182111111E
.52.......
.52.......
.51.......
.4........
.3........
.3...S....
.21221....

jumps 
