11
11
1
...2321111.
...21....S.
...2v......
233I<......
1>I311111>1
...2.....>2
...2......E
...I.......
...2.......
...2.......
...1.......

jumps 
