11
11
1
..E.111..11
..S.^1I11I1
.vJJ.J<..I1
12J.>11J.^2
122........
.11........
.II........
.11........
.1^........
32^........
321........

jumps 2 2 2 2 3 
