11
11
1
...122.....
....13.....
....I3.....
....13.....
1<..v^.....
E1..1^S1111
1I1I1.1..>1
11....1..1.
11....1..I.
11....>1121
11.......11

jumps 
