10
10
1
....14....
.....6....
.....6....
.....6....
.....6....
E1111821..
.....7....
..12S02221
.....5....
.....2....

jumps 
