11
11
1
...11......
...11......
E..1S......
1..12......
3<.2311>1..
2..22...1..
1113311II<.
...22...1I.
...^2...>^.
....I......
....1......

jumps 
