11
11
1
12......11.
1IIIE<23<2.
13.......2.
.2.......2.
.1.......2.
1<....S1I31
1>11J..>122
.........^2
...........
...........
...........

jumps 3 
