11
11
1
...........
...........
...........
.....>3E<..
.....1.....
22IS13I2222
3....2....2
3....2....1
32222^.....
1..........
...........

jumps 
