11
11
1
........11.
........111
........>I3
.1..J.J1I21
.1.......1.
.1.......S.
.1........1
2I2J..J..12
22<.......1
111..v11111
.11..E.....

jumps 3 2 3 3 
