10
10
1
12122E....
.1.11.....
.1.11.....
.1.11.....
.1111.....
.1211.....
.1311.....
.1411.....
2S7331....
23762.....

jumps 
