11
11
1
..1........
..2........
..2........
..2........
..2........
..S>J.12J12
........113
........I.2
.......vE11
.......23>3
......13333

jumps 3 2 
