11
11
1
....111....
....211....
....221.S12
....11....2
....^2111I1
.....1v....
......1....
......1....
..>1112v...
..^1112EI21
.......31..

jumps 
