11
11
1
...........
1<1211<....
2..I..^...1
2>>2..^1112
...1......1
...1.....>2
...1.....^1
...1.....S.
1v.1.....2.
21.1.....2.
33E2.....1.

jumps 
