11
11
1
........122
.........13
..........2
.1.J111J112
122v<......
2S.3.......
31.J.......
1..IJ......
...1^......
..1E1......
...2.......

jumps 2 3 3 3 
