11
11
1
.32111.....
.^1..1.....
.21..1.....
.31.1211v..
.I1.S1..1..
.^<1121I211
.....I..1.2
.....E..>>3
...........
...........
...........

jumps 
