11
11
1
....111.1E.
....1.I>^..
1...I.II...
211J.1J^1<.
1..........
1...J......
2<..S<1....
.^1..J21112
......1>333
......v1...
......11...

jumps 2 3 3 3 
