11
11
1
...........
...........
.........11
.....>Jv1I2
.....^11.1.
.........v.
......S..1.
....>JJ<121
....1..1.11
....I.11vE2
....1133322

jumps 3 3 2 
