11
11
1
...........
...........
...........
...........
...........
.....v..>21
2....E..^<1
31I112112<1
1>3S2I23321
.....1.1...
.....221...

jumps 
