11
11
1
....1......
11113......
1...IS11111
222<3.....1
3...I.....1
31E.^1111I2
.....>22II2
...........
...........
...........
...........

jumps 
