11
11
1
..1121.....
.v1..1.....
.>11JvI>111
....^21.J12
..........2
.........v2
...>JJ1SJE3
.........21
.........2.
.........2.
.........21

jumps 2 2 3 2 2 
