10
10
1
.....12122
.....13122
.....13.11
3111123122
311112E.13
.....12123
..S1112121
......1.1.
......1.1.
......111.

jumps 
