10
10
1
....1.12..
..12433422
....1.1323
....E12322
..12212221
......111.
......111.
......11S.
......112.
.....2311.

jumps 
