11
11
1
..1132.....
..S12I.....
11<121.....
11v1^3<....
..11Iv2....
..1..v2....
..>1Iv311E.
.....>^....
...........
...........
...........

jumps 
