11
11
1
...11......
...Ev......
1113<.....1
11>211Jv122
...J...J...
1S.J.......
211^.......
1......J...
...J123I<..
...1v..>^..
...121.....

jumps 3 3 3 3 2 2 
