11
11
1
...122.....
...I.I.....
...I.^E<...
...1..1I...
12S1..11...
..>211221..
...1.23^1..
...>132.v..
.....21.1..
.....21.1..
.....1111..

jumps 
