10
10
1
..........
..........
111111E...
1.11112221
2.1...2...
4S42223...
.12...1...
2453212221
112.......
111.......

jumps 
