11
11
1
...121.....
....1I.....
1....1.....
2...J1.....
3222221Jv11
1.......1..
....J...1..
....1..S211
....^1<1211
......>2E21
........21.

jumps 2 3 3 
