11
11
1
.1231......
..13.......
..1^.......
..1I.......
..1^..v....
..11..E....
1.>211^....
211211S....
1..1.......
11121Iv....
...1111....

jumps 
