10
10
1
.1........
.2E.......
132111111.
121.....1.
121.....1.
2221233221
3432221S21
.21..1....
.21..1....
.11111....

jumps 
