11
11
1
11.........
21.........
E<.v.......
2..J.......
1..J.......
2..31>I11..
3..^....1..
2..1....>I1
1.JI11I1111
...1S......
...22......

jumps 3 2 2 
