10
10
1
.....12232
.....12243
......1132
1111112S31
111111121.
.......1..
.......1..
11111E.1..
2111111221
1......121

jumps 
