11
11
1
.......11..
.v.....11..
.2E....v1<1
.1...>221>2
11.J111J113
11....>J..2
.....J.1S..
.....3.JI..
.....^2<<..
.......I...
.......1...

jumps 3 2 3 3 3 
