11
11
1
......1....
......2....
......31v..
.....vI12..
...S.E3.2..
...I.^I.^..
...v..3....
...1..3....
...>v.3....
....1.I....
....2231...

jumps 
