10
10
1
..........
..........
..........
1.........
3......111
66S6653322
1.1....1.1
..1...E1.2
1121112212
111...11..

jumps 
