11
11
1
..E11......
....1......
1<11S......
1v..J......
.3..1......
.3.........
131..J<.J11
11..J.....2
1v>1^.>>112
221...1....
1221111....

jumps 2 3 2 3 
