11
11
1
..12..1....
..12..2....
..v1..2....
E1<1..S....
...I..1....
...1..1....
...1..1....
...221211<.
..v2<.1..1.
..I1..>>v1.
.131..1221.

jumps 
