10
10
1
E5..143...
12..121...
2312321...
2312321...
1312231...
.2.S.2....
.1.1.2....
.....2....
.....2....
.....1....

jumps 
