11
11
1
....23E1...
22223^^....
1.........1
1.J.J..JI<3
1I1v.S1J..2
...11......
....J......
....I......
....^......
....2......
....1......

jumps 2 2 3 3 3 
