11
11
1
.121.......
..II.......
..11.......
..11.......
.>E<.......
..1........
..I1.......
..I2.......
..131111...
..13..121S2
..12..22..1

jumps 
