11
11
1
...........
.v1111<....
.1....^...1
.1....^.J12
.1........1
.1.....>J.3
.11>11J1.13
...Ev.JS223
....J.11>>2
....1......
....21.....

jumps 2 2 3 3 2 
