11
11
1
3E2...11.11
3^1111<1.11
221I1112121
1I.....1.1.
.1.....^1<.
.1.........
.S.........
...........
...........
...........
...........

jumps 
