11
11
1
...........
......>1111
......1...1
......1...1
......1...1
......1...1
......1.>v1
.....S1.2E2
.....11.1^2
.....I1v2I1
.....1121..

jumps 
