11
11
1
......1231.
........^1.
.........1.
.......J.1.
........1<.
.......J>>3
2EJ2..J3232
111>J.22J^1
...1.......
...1S......
...11......

jumps 3 2 2 3 2 2 
