11
11
1
.......1...
.......31v.
.......3.21
.......^131
.........2.
.........2.
.........21
1EI333332S2
.........11
.........21
.........1.

jumps 
