11
11
1
...........
...........
211J.11vS22
3<.....J..1
2..........
2..J.J.J111
E1111<>J.I1
.....^1....
.....112...
.....11v...
.....133...

jumps 2 3 3 2 2 2 
