10
10
1
1.....2212
2111114323
E111236432
233S223...
......2...
......2...
......2...
......2...
......2...
......1...

jumps 
