11
11
1
121112E....
.111.I.....
.1I..^.....
.12J.......
.121.......
.S1........
.>IJJ<.....
..11.1.....
..>31^.....
...2.......
...1.......

jumps 2 2 3 
