11
11
1
21.........
2^.........
E1.........
13.........
.^>I1111111
.11.v11...1
.12.1.^I111
.I3.1......
.1S1<......
..2........
1231.......

jumps 
