10
10
1
...224....
...S.5....
2333262222
1....4...1
211115111.
1....4..1.
.....4..1.
.....3..1.
.....2..E.
.....1....

jumps 
