11
11
1
...........
...........
....v11S...
..v.1......
..2.v......
..2.J......
..2.v.....1
..313.J<212
..I.311^J.1
..3.1....21
..E2....131

jumps 3 2 2 
