11
11
1
1..221.....
3322I^....1
1E.>I111112
.2........1
.2...S....1
.I...vI1111
.^<..v.....
..^I2<.....
...........
...........
...........

jumps 
