11
11
1
...........
....1E22<S.
....1...21.
....>111I21
...v1111321
...1....21.
...1>1>1^I.
........11.
........1v1
........1>3
........111

jumps 
