11
11
1
........E..
........I..
........1..
..........1
.>11>J..J.2
.1......^11
.1.......v.
.I.......S.
.1.......3.
1323333<13.
.111....23.

jumps 3 2 
