11
11
1
...1...23..
...I...1S..
1112...I^..
1..1...1...
211I1111...
1..I.>11111
...v.1....1
...1.1..E<1
...1.I1....
...1.12....
...1122....

jumps 
