11
11
1
......1211.
.....S>3331
2I11.J1221.
2......11..
2<.....J1..
111v....1..
...1....I..
1IJ<1J.JE1.
........1..
.......>1..
.......1...

jumps 2 3 2 3 3 
