11
11
1
.........22
..v111<1121
..>1J.v>332
......J1..1
....>112111
.......^111
11S...11...
1111J..J111
...........
...........
.......E...

jumps 2 3 3 3 
