11
11
1
...........
...........
11<11122221
1.....1....
111I1>3<...
......1I...
......11.S1
......E1vv1
......21I1.
......212I.
......12321

jumps 
