10
10
1
....1.....
....2.....
....2.....
1223533343
..134S2222
..12211111
..111.....
..111.....
..111E....
..1232....

jumps 
