11
11
1
...........
...........
...........
...........
...>S22222.
1III1111133
3<.1....>23
2..1......1
1..^..E<111
1..1.......
22121......

jumps 
