11
11
1
......11...
......22111
.....v32111
.1...121...
.I...121...
.E...1I1...
.1...1^1...
.I...1.^...
.1v11<S21..
.11....I1..
.11...121..

jumps 
