11
11
1
1E....12...
.1.....3...
.1....v31..
1^.J11JJ...
........J..
......JJ1..
......^11.1
.......2^<2
......S3123
.......2.^3
.......1.12

jumps 3 3 2 2 2 2 
