11
11
1
..23111...1
..^^1121I12
......J...1
.........>1
233J.JI<.1.
111J..J^1S1
...........
...........
......1....
......v....
.....12E...

jumps 2 3 3 3 3 
