11
11
1
........11.
........331
........^31
.........21
.........^1
.........11
.........11
.........11
.....1.S>32
122I2312121
.....11E21.

jumps 
