11
11
1
.......11..
.......11..
..v....21v.
..2....^J1.
E1I.J..J222
11J.JS....1
11^.....J..
..v.....1..
..J<....1..
...1>111Iv.
..221...131

jumps 2 3 3 2 3 2 2 
