11
11
1
...........
...........
.>S11111111
233<111..v1
222I223I3<.
1..........
1..........
1v.........
E1.........
11.........
22.........

jumps 
