10
10
1
..12......
..131..111
..12112311
112421.E..
2223.1.1..
11132S3421
...1.2.2..
.....1.2..
.......2..
.......1..

jumps 
