11
11
1
........11.
........I1.
.....vI12<.
.....3..1..
111I1EIS^12
1....2....2
1....^....1
21>1II11I11
2.1........
31^........
21.........

jumps 
