11
11
1
...........
....v1<....
....1121111
......1...1
......S...1
11..J..J112
11>2J..J..2
1>J11IJ2232
.......1..E
.......1..1
.......1221

jumps 3 3 3 3 2 3 
