10
10
1
....1452..
.....221..
.....212S.
.....2.1..
.....2.1..
11111E.1..
1123373321
.....411..
.....411..
....13....

jumps 
