11
11
1
...........
...........
.....E....2
...>12..>I3
1I1I13112<1
11.1.1..S..
.1.1.......
.v.1.......
2323I<.....
31.1.......
2122.......

jumps 
