11
11
1
111........
1.1........
212I>>v....
2SJ...J....
211JI1<....
1.v........
1.3...1....
113EJ.J<...
..11...1...
.v1^..>^...
.232.......

jumps 2 3 3 2 2 
