11
11
1
.....12....
..1E11<....
...........
232...J....
1.1........
1121..JS2I1
1.1...J....
21<...1....
1.....1....
11v1..1....
..2311232..

jumps 3 3 3 
