11
11
1
......3E...
......^1...
11111132<..
2v....2....
11....2S...
.1....21...
.1....^I...
.>11v<^v...
....>3^1...
.....1.1...
.....111...

jumps 
