10
10
1
..111242..
..1..S42..
..1...32..
..1...22..
..1...22..
..1...2E..
..1...23..
..1...23..
..1...3521
..11114521

jumps 
