11
11
1
.......22..
.......1>I2
.......1..2
.......1..2
.......1..1
.......S..2
1..>E<...v3
322311111<1
1..2.......
...2.......
...1.......

jumps 
