11
11
1
11222232...
1.2E1.S2...
111J21^J...
...JJ..2...
...I...J...
...........
....1..J...
...JI..^...
...^1......
...I1......
...22......

jumps 2 2 3 3 3 3 3 
