11
11
1
..1........
.S2........
.12........
.IJ........
22J.J.1I111
2.1.......1
111....1111
.11....v...
.1J....1.>3
12<....>E22
221........

jumps 2 2 2 2 
