11
11
1
........1..
........S..
1.......2..
222IE1I<1..
...111I21..
...1...1...
...v...1...
1..v...1...
333<...1...
1>1111v1...
......31...

jumps 
