11
11
1
...........
...........
...........
...........
...........
...........
E11111<.J11
22SJ..2J..3
1.....v12I3
1III113I212
.....1222.1

jumps 2 3 3 
