11
11
1
...........
.1.........
12.........
331v.......
332322222<.
2<.1.....I1
111E111>132
.........^1
.........S.
...........
...........

jumps 
