11
11
1
..........1
..........2
E111111.J12
......>>222
..........1
..........1
.vI1<1JJ111
.I.........
.>J.S1J12<.
....1.1v...
....1123...

jumps 2 3 2 2 2 
