11
11
1
...........
...........
...........
....S......
....1......
....1......
....1.>3I21
1>112v11...
3222<1I1...
2111>v11...
.....E321..

jumps 
