11
11
1
..1121.....
21>12v.....
E2S..1.....
1^1..J<....
111IJ.1J112
..........1
.....1.....
.....1J....
.....v1....
....v3I....
..12331....

jumps 3 3 3 3 
