11
11
1
...........
...........
...........
...........
...........
.....1>3333
111<12S<113
1111I2<...2
11...1....1
2I1112v....
E1..121....

jumps 
