11
11
1
...........
...........
...........
...........
...........
...>I111E<.
.>>3>I11121
123I11111<.
1121.....S1
21^<111<111
21.........

jumps 
