10
10
1
....2.....
....4.....
1.E.411111
2.1.3....1
3342522222
113S411111
..213.....
..112.....
...11.....
...11.....

jumps 
