11
11
1
.E211......
.31.1......
.I1.1...Sv.
.3>1^....1.
.3.......1.
1^.......1.
1..J..J.J22
......>1122
......1..1.
......^v.1.
......12121

jumps 3 3 2 
