11
11
1
.........11
......v<I21
......J..S.
.......vI21
.....>J1.12
.......1E<2
211J.JJ1.22
2....^3>J22
1.....^..^1
.........^1
...........

jumps 2 3 3 2 3 2 
