10
10
1
.....14322
1111123222
2333224S32
.....1411.
......3...
......E...
......4...
......4...
......3...
......1...

jumps 
