11
11
1
...12......
..113......
..213......
..2v3......
.13<3......
.>E1I......
..11^......
.122^......
.^22.......
11S^.......
111........

jumps 
