11
11
1
..2212.....
..>Ev1.....
..S^Jv.....
..J1.J.....
...13I.....
....J......
...........
...J.J.....
...132.....
...132.....
...1331....

jumps 2 2 3 3 3 3 
