11
11
1
..2E.......
..3........
..^........
..1...1....
113...2....
2.I...2....
31^...21111
1v2I<121111
.11...1....
.11...S....
.11...1....

jumps 
