11
11
1
....2332...
....I^1....
....21....1
11S1J1122I2
1.1........
111.J.1J..1
...>E.J.J11
....^......
...........
...........
...........

jumps 3 2 3 3 2 
