10
10
1
...1..1...
...2..2...
...2..2...
...2..2...
...2..2...
1224224E21
...2..S111
...2116111
...21.5...
..13213...

jumps 
