11
11
1
.......2211
.......1.>2
.......v.^1
.......J.1.
3<.......1.
2^.......1.
21.J..J<.1.
1.S......1.
E12I11111^.
112222<....
...........

jumps 3 2 3 
