11
11
1
...........
....>233IS1
......I1..E
......1>333
......11111
......11...
......11...
1111<I2<...
1.....1....
1.>111^....
1121.......

jumps 
