11
11
1
.111121....
1S1........
1>2111>1>v.
..J..J...32
.....^...12
..1..^III22
..v........
E1I11<.....
..1..1.....
..1..1.....
.12111.....

jumps 2 3 
