11
11
1
........131
........v^2
........SI1
....v2<2<1.
....2....1.
1...2....1.
2...I....1.
22223I1E11.
....I..1...
....>111...
...........

jumps 
