11
11
1
...........
...........
...........
.........>1
.........11
.........11
........132
1......1S33
3I2113I<v^2
E....2..11.
1....33111.

jumps 
