11
11
1
...........
........E22
.........11
........>21
........>22
..1>J..1111
1.1........
212J2.J2321
..1....^S..
..I....II..
..11...12..

jumps 3 3 2 
