10
10
1
12211121..
..1...21..
..1...21..
..1...31..
..1...31..
1121113212
1.S...21.3
2131112234
1.2...E..2
..1......1

jumps 
