11
11
1
....11.....
1...1^.....
32223E1JI<1
1...v.....1
....JJ...>2
.....1...22
.....2..1^2
....1S11^..
....>^.....
...........
...........

jumps 2 3 3 
