11
11
1
........1..
........2..
........2..
..S.....I..
..>1I1v.2..
.....v<.2..
.....3.>3..
.....3..2..
.....3..2..
1<<11I112..
1E1..2221..

jumps 
