10
10
1
......3233
......3.12
1222224232
......1.1.
......1.1.
......1E1.
1111112221
1111113321
......S1..
......21..

jumps 
