11
11
1
...........
...........
...........
...........
...........
.v122223I<.
.E1211<1.1.
..11..Sv.I.
..>^..I2>I1
......13333
.......1112

jumps 
