11
11
1
...E22331..
...1..I21.1
...^1123222
......1....
......1J...
......1I...
......J2...
..SJ..2v...
......IJ...
......22...
......12...

jumps 2 3 3 2 
