10
10
1
1353521...
21216E....
21227221..
1...5.....
....S.....
....4.....
....4.....
....4.....
....4.....
....2.....

jumps 
