11
11
1
....131121.
....1^..1..
....I...I..
....1...I..
....1...1..
....1...1S.
....1..v11.
....I..211.
....1..211.
.v112112v21
.2111..1E11

jumps 
