11
11
1
........2E3
331.....211
2211111>211
.1.....>3I1
.2......^..
.3.........
.3.........
.3.........
.^<<1......
....S......
....1......

jumps 
