11
11
1
...........
...........
...........
...........
..........1
........S12
21I1I1<...1
2>1Iv.1...1
211<I121112
2>112vI...1
....1E2....

jumps 
