11
11
1
...........
...........
...>v......
....2......
...Jv......
...2J......
...^1......
1I1.1......
332JS<.....
1.113......
..1232321E.

jumps 2 3 2 
