11
11
1
..131......
...31......
...21...S..
..v3<111211
..21....1.1
..21....>11
1121.......
1.1^.......
3<.........
3..........
3211E......

jumps 
