10
10
1
...2....2E
...4....12
...4....1.
...4....1.
...S11112.
.115222241
.1.2....1.
11.2......
1..3......
221431....

jumps 
