11
11
1
1....122...
33S2<112...
1.....12...
1....JJJ...
1....1.....
1I11>^.J...
...I^.J1...
...1^..1...
...11.1I...
...11.vE...
...11.11...

jumps 2 3 2 3 2 
