11
11
1
...........
...........
...........
.....J.....
.....1.....
........vv.
.....E..22.
11..JJJ122.
1>2SJ11112.
2I22<1.112.
122111.1231

jumps 3 3 3 2 2 
