10
10
1
11...21...
11...2....
33222S2222
E1...3...1
.1...3....
.1...3....
.1...3....
.1...31111
.211131111
23...21...

jumps 
