11
11
1
...........
...........
.S1I11>v<..
......^31..
......131..
......^I1..
......131..
......131..
......231..
......^31v.
......133E.

jumps 
