10
10
1
......12..
......13..
......13..
......13..
......13..
1.....13.1
3E22223S33
3111112212
2.....11.1
331...11..

jumps 
