11
11
1
..1121.....
.E1.^1.....
.11..^>v...
.11....v...
.......2...
.....JJ1..1
11J.JI^2J.2
12333^1J211
......S.1..
........1..
.......11..

jumps 3 3 2 3 2 3 
