10
10
1
..13.132..
...4..22..
..173S4521
...5...2..
...E...2..
...4...2..
...4...2..
...4...2..
...2...2..
.......1..

jumps 
