11
11
1
...........
...........
11112S<....
1...I1.....
1...11.....
11II2211122
....11...23
....11...22
....12...E1
....13...11
....12...11

jumps 
