11
11
1
.21........
.32I1I11112
.2v.......2
.21.......1
.21J..IJ.>3
.2........1
.2.........
.2..S......
.2..1......
.2E<1......
13221......

jumps 3 3 
