10
10
1
....11....
....11....
....12....
....13....
.S..12....
222.11....
225111....
.17311....
1E72.1....
237521....

jumps 
