11
11
1
.......111.
.......I11.
1112333S21.
2...E..^...
21I12111...
....1..1...
...121<<...
...11......
...I1......
...11......
...11......

jumps 
