11
11
1
...........
...........
...........
...........
....>11I11E
1I1<21<....
1...1.1....
1...1>^....
1...11....1
222I3S2I222
111123.....

jumps 
