11
11
1
...........
......v<...
......JI...
..........1
......>1I13
.......Jv12
........J..
.......J...
1111S22E321
1123321^211
........111

jumps 2 3 2 2 
