11
11
1
...........
...v..1<...
...I..11...
12231<2IS..
11121122v..
2<.1..111..
.1.1..>Iv..
.^1<...IE..
.......11..
.......11..
.......11..

jumps 
