11
11
1
....221....
....211....
.v<<21..E..
.1..I1..^..
12113JJ.^..
11.J1......
.1....J....
.I.JJJ1....
.1J12>^....
.SI^I1.....
....121....

jumps 3 3 3 2 2 3 2 2 
