11
11
1
..11.......
122<...11v1
.1.1...I.>E
.v.1v......
.1.11..J...
121SJ..I...
21.........
31..J..J...
3<..>>22...
1...1..2...
....1..1...

jumps 2 2 3 2 
