11
11
1
.111.......
13IS.......
.^.v.......
...I.......
...1.......
...211<1<..
...2....1..
2..2....1..
E113>111211
3223....^11
1..1.......

jumps 
