11
11
1
...........
...........
......1....
......S....
2<....1....
333333<....
2332111....
......v....
..>1112>1E.
..^11.>v...
....1122...

jumps 
