11
11
1
.......121.
.......12E.
..v.....12.
1>3J1.1JS21
.11....J1^1
.1J....^212
.1......>I3
.2<........
.2.........
.2.........
.1.........

jumps 3 3 3 2 
