11
11
1
....E......
....1111...
.......1...
.......1...
....J.11111
........v12
.......J3<1
3311J..JS<.
2.......J21
1>1>III1121
........11.

jumps 2 3 3 3 2 
