11
11
1
...121...1.
....1S...E.
....1....1.
....1....1.
333I<....1.
2........1.
2111v>1>1^.
1..111.....
...211.....
..>32^.....
..121......

jumps 
