11
11
1
.....1.....
.....I.....
.....2.....
....S2>v...
....JJ2J...
......2....
....1J22...
....I22J...
....322....
....33^....
....2E32...

jumps 3 3 2 3 3 
