11
11
1
..E..23....
..3..1I>111
..^11<^I111
.......1...
.......I...
..vS...1...
..3....I...
..3>1I1^...
..I1.......
..3I.......
..221......

jumps 
