11
11
1
...........
...........
...........
...........
...........
...........
..>22S11111
..........2
........113
2333I333323
23211E....1

jumps 
