11
11
1
...........
...........
...........
21v........
2.1........
1.>JS.111E1
.........11
..1.v<.J121
.12J<v...11
.2211I...12
12111111122

jumps 3 2 2 
