11
11
1
.....12....
.....1v.v..
......J.321
.....J..J..
......J....
........v..
3E<.JJJ12..
.....S2.2..
.....2I.I..
.....3^.2..
.....2..1..

jumps 2 2 2 3 3 3 2 
