11
11
1
...........
...........
...........
...........
...........
.>11E......
13<........
.>2.....>22
12311111312
12S.....2<2
122122111.1

jumps 
