11
11
1
..21..1111.
..3I.....1.
1.I>22J.v1.
33E1J.J<2<.
11^2..J1<..
...1.......
..S1.......
122^.......
...........
...........
...........

jumps 2 3 2 3 
