11
11
1
...........
...11112<..
...>33323I1
....Sv1.1..
.....I1.1..
11E..>2v1..
11<111121..
.......1^..
.......1I..
.......v1..
.......11..

jumps 
