11
11
1
...........
.>11111v...
22<211<<...
21.2.......
11.2..S....
121v..1....
13v3J1<....
.^1J.......
.1J........
.1.........
231E.......

jumps 3 3 2 
