11
11
1
....1......
....2......
111<S......
21v.1......
1.1........
1.1........
223<.......
23211......
2I21<......
132........
23E1.......

jumps 
