11
11
1
...1..112E.
...2..v^.1.
...2..I1.1.
.v.J111..1.
1<.J....>^.
1>23J..J...
...v...1J..
...1>21I1..
...11..S...
...11..1...
...11......

jumps 2 2 3 3 2 
