11
11
1
.......11E.
12I22223321
..>1I1vI>11
..I...11...
......JI...
11J........
11..J<1S...
......JJ...
.......1...
......I^v..
......232..

jumps 3 2 3 2 3 
