10
10
1
...221....
...321....
..1321....
..2321....
..2321....
..2321....
..2322E...
..2311....
..24S2....
..3521....

jumps 
