11
11
1
...........
.......>111
.......1..1
.......1..1
..E1III2I11
.>I11112I21
.1..S......
1333<......
3I<........
31.........
21.........

jumps 
