11
11
1
..1.....1E1
..2.....v1.
..3v....2I.
..^J....2^.
..1.....11.
..1.....J1.
...>J..1^I.
..J.....11.
2<I.....1I.
2S1.....v1.
121.....32.

jumps 3 2 3 2 
