11
11
1
...........
...........
...>I1.....
...1.1>11>1
...S.11.v11
...3.11.1..
1..^.1^.1..
E33I<I21<..
.....1I....
.....>2111.
......1111.

jumps 
