11
11
1
11.........
11.........
3<.v11122S1
E1.>IJ.J1I1
.I.........
2^.....v...
3311J..J112
.......J..1
.......1...
.......2...
.......1...

jumps 3 2 3 3 2 
