10
10
1
11.......4
11..122227
1211111E23
.211111111
12.......1
24S1111112
.2.......1
.2........
.2........
.221......

jumps 
