11
11
1
...11......
...11......
...11S111>1
...Jv...>I3
....21.J112
....J.....2
...>IJ.>3I3
.E1..J<1111
....J......
....1......
....1......

jumps 3 2 3 3 3 2 
