11
11
1
...13211..1
....33I2123
....2I.1.11
....13.1.1.
....1^1<.1.
....1....E.
..v.1......
..2.1......
..S1^......
..^........
...........

jumps 
