11
11
1
....11111..
....1......
1...1...J..
32<.v.>>^..
2..J<.1....
211v..S....
1..J..2....
......2....
......^....
12I211>33E1
.111.......

jumps 2 3 3 
