11
11
1
........11.
.S......11.
121Iv...I1.
1<..1...11.
....1...11.
....1...11.
E11I211I<1.
....1....1.
1v11<....^.
3I1111>1121
21.........

jumps 
