11
11
1
11.........
11.........
11.........
23<1S......
233332<....
.1E<211I1<1
...>2I11111
...1v......
...I1......
...1v......
...11......

jumps 
