11
11
1
..1....1111
..2....I>I1
..I.v113<21
..2.J...1>1
..2.....1..
..1.....1..
..J.1...1..
..1.J...I..
1131J.J.^..
11S.E......
..1.1......

jumps 3 2 3 2 2 
