10
10
1
....2341..
..123S8221
......5...
......5...
......5...
.....E5...
.....15...
.....15...
.....161..
......42..

jumps 
