11
11
1
.....2233..
.....1.^^..
.....>11IE1
.......J.^2
.......^<12
.......11I2
........111
...S.......
...1....J..
...I.>1v1..
...133.221.

jumps 3 2 
