11
11
1
.22........
2I<11<.....
32E..1.....
1.>212.....
..21.^.....
1.21.......
21^1.......
1.11.......
11I<.......
.S1........
1331.......

jumps 
