11
11
1
....12E....
...>1^.....
...1.......
1>1^.......
21<........
22^J1..J11.
.........1.
.........I.
1>J12232JS2
2^.......23
1........12

jumps 2 3 2 2 
