11
11
1
.........23
.....S111^3
..........3
..........2
..........1
.........11
.........1.
1........1.
E<11<....11
2I..I..1122
11..1122.22

jumps 
