11
11
1
......12...
.......2...
E11<11132I1
...SI111..1
......12112
.......1..1
.......1vI2
.......11.1
2222I222<..
1..........
...........

jumps 
