11
11
1
...11......
....1......
..1J1......
..1.1......
..1.1......
....S......
1.JJI......
1.1.v......
233J2J1IE22
..11I.....1
..133......

jumps 2 2 3 2 2 
