10
10
1
.E2.......
..^.......
1.........
2.J.......
3S1.......
41........
3.J.......
411.......
4.........
322222221.
