10
10
1
...1....11
...>1I1121
131J1<..1.
.2.32.J1<.
.^.IJ.....
...3......
...^J.....
...I......
...^S.....
....11E...
