11
11
1
....22.222.
....I1.3<3.
....J^.21^.
.......J1..
....1...^..
....1J.J...
....J1..J..
.....I.v1..
....JS.31..
.......I1..
....111E31.

jumps 2 2 3 3 2 2 2 
