10
10
1
11111.....
11..1.....
.I.S1.....
.1.II.....
.1.J1.....
.I..1.....
.1.>3.....
.1..^.....
.vE11I11..
2421111221
