11
11
1
....135600E
......1.1.6
......1.337
......1.2.2
......11322
........222
........1..
........1.S
........113
..........4
..........2
