11
11
1
......23352
......11252
...11121122
...1..21123
...1..1..12
...22222244
1222S....23
.........2E
.........15
.........15
..........2
