11
11
1
...........
...........
...E111...1
......1...2
......21123
......3..23
......411S3
......3.122
....1352211
..122235444
....1235443
