11
11
1
.....1....3
.....311116
.....3....4
.....441..3
.....341..3
.....342..3
.....232113
.....221144
.....1.1123
.....S.1..E
.......1233
