11
11
1
......12235
.....111117
.....1....5
....1322224
.....111124
......11234
......2E.13
......24124
......25224
.......2..3
.......1..S
