11
11
1
21111111114
3.........7
31123333E27
1.........5
..........5
.......1226
..........4
..........3
......S1114
.......1..3
......14432
