11
11
1
.1121111S.1
11.2...1233
21121111133
2........E3
3........13
4........13
4.........1
4..........
4..........
41111......
21112356542
