12
12
1
...1E1123233
...11...1112
...11......1
...11......1
...11...1..1
...121112..1
...12...1..1
...12...1..1
...121112223
1..11......S
2..11......4
222332234444
