12
12
1
............
123321111111
..1........1
..1........1
..1........S
..E.11111112
213231222222
3.1.2.1....1
3.1.2.1....2
412131211..3
5.11311.1..3
41..1...1112
