12
12
1
...........1
...........3
...........5
...........6
.......12116
........1.15
......22E114
.1222256S777
......1.1114
......111225
...........4
...........2
