8
8
1
1.....1E
2111112S
221....4
..1....3
..1....3
..1.1114
112.1.13
11211...
