8
8
1
15766785
...S..12
...1..11
......E.
......2.
......2.
......2.
......1.
