8
8
1
....1464
..112454
..1....1
..1....E
..1...11
..1...11
..12S232
...12221
