8
8
1
S1111E33
.......2
.......2
1......2
2......2
2111...2
1..11113
11234444
