8
8
1
2222....
31.21...
44454321
11.....E
.1......
.1111221
.....1..
S11111..
