8
8
1
........
.....111
.....212
.....1.2
.......2
.....S13
....1335
1344577E
