8
8
1
111111..
311211..
32342232
23321..1
....1..1
...S2111
..1E31..
........
