8
8
1
122S3332
.......1
.....122
......12
.1222122
1222E231
....2.2.
....1.21
