8
8
1
221.....
2.......
E.......
1......S
12332111
121.....
.1211211
..234675
