8
8
1
....2256
11234115
21211114
211....3
1......2
1111ES11
........
........
