8
8
1
...11111
...1...1
..121122
..11....
11222S42
123E1111
..21...1
12431111
