8
8
1
...16543
...17114
....4..4
....1..4
.....11S
....E213
.....112
.....122
