8
8
1
..134556
...1E115
.125S554
...1...1
...11112
.......1
........
........
