8
8
1
.....112
..123424
.....234
.....122
.E1246S3
...1..3.
...2112.
...1....
