9
9
1
.11124531
.1....1..
.1....1..
.1....1..
.1....2..
.1....3..
.111236E2
S33211421
......1..
