9
9
1
.....1134
.S2211.14
....12224
.....112E
.....1..6
.....1115
........3
........3
.....1223
