9
9
1
.........
.........
.........
.........
.........
..1225554
.....42S4
.....4334
..E125553
