9
9
1
........E
........1
........1
........1
........1
...11S331
.111.222.
.2...211.
387765442
