9
9
1
121124321
.1...1...
.1...1...
.11237422
.1...3..3
.1...S1E3
121112223
........2
........1
