9
9
1
.....1211
...S111.1
........1
.12111123
..1..2224
..1..1.14
122112125
.....1114
....122E4
