9
9
1
211223442
3..112314
3.....217
2.122222S
1......14
E.......2
........1
.........
.........
