9
9
1
........1
...123425
......2.6
......S26
.....2535
......1.4
122222214
.E1111112
.........
