9
9
1
.........
.........
........1
......1.2
......214
...123667
......236
......1.5
..E111S08
