9
9
1
.....1221
.......11
.......11
.....1111
.1211S33E
.12..4114
.12..5114
.12114115
.....1124
