9
9
1
....11113
.1..12336
.2......4
132221..S
11.E....1
24331...2
122211113
..11....2
......122
