9
9
1
1..122223
211E.2226
1....2115
1....1113
1.S111464
11112231.
....1.1..
....1.1..
....111..
