9
9
1
122212331
...1...21
122332221
...12.222
...12.212
...221S13
...211113
...1....1
12E1.....
