9
9
1
257754653
.11.22421
.12222421
..S1123..
......1..
......1..
......1..
......E..
.........
