10
10
1
1.........
2.........
333321111E
1.....2332
1.....1..1
1...112122
1111323111
....S23221
....111221
.....11221
