10
10
1
.112333433
.111113426
......11.5
....136808
......1.S2
......E...
..........
..........
..........
..........
