10
10
1
..E1112234
......1.15
......11S5
.111111114
.1.......4
.1.......5
.11111...5
.....33345
.....2..22
.....11221
