10
10
1
.......211
.......3.1
.......2.1
.122222322
.......234
....1....E
....2..124
134452S223
...1321111
..........
