10
10
1
.1222S5555
...1.11.16
...1..3556
...1113544
.......1.2
.......112
.........1
.........1
.........1
.........E
