10
10
1
..11112111
..1..S3111
..1..13332
..1.122311
..11355511
...E1113.1
...11..411
...11..3..
...11..2..
...12211..
