10
10
1
133343431.
.1..3121..
.2223.11..
.1..2E3322
.1..1..1.2
.1..1111.2
.111S21112
.....1...1
.....1...1
.....11111
