10
10
1
..........
..........
..........
..S1111111
..2......1
1131111111
1.2....121
1.1.111221
1...1..111
35555E6564
