10
10
1
3566E56421
1.1...1...
1S21222242
....1...11
....1....1
....1....1
.122211112
.........3
.........4
.........2
