10
10
1
111111122S
1....11211
1....1.111
1..1233432
1122222211
111111....
.....1....
.....1111.
...133334E
..12211121
