10
10
1
....122233
.........2
.....S1113
......1E12
......1113
.....13346
......1125
......1115
......11.4
..12224566
