9
8
1
.1111111.
111111111
111111M11
111111111
111111111
.1111S1..
.........
.E.......
