8
10
1
..000N..
..0.....
..0.....
000.....
0.......
0.S1....
0N.T..00
0000...E
.....000
........

pistons v >
